width 20
height 20
@@@.@.@.....@.@.@@@@
@@......@@.@..@..@@.
@@@@.@.@.@...@.@....
@@.@@.....@@.@...@.@
@.....@@@.@.@.@.@@..
.@.@.@.@........@..@
...@@....@@@@.@@@@.@
@@...@.@..@.@@@@@@.@
@.@.@@@..@.....@....
...@@@..@@@.@@@.@@.@
@.@.@.@..@@......@..
........@@@@.@.@.@.@
@.@@.@.@..@@..@...@@
..@.@.@.@.@.@@.@.@.@
@...................
@@.@.@.@.@@@@.@@.@@.
@@@...@@@.....@.@@.@
@@@@.@@.@@.@.@..@...
@@@@......@@.@.@.@@.
@@@@@.@.@@..........
10
19 8 0
15 9 0
18 6 0
8 6 0
12 10 1
7 18 1
18 5 1
5 16 2
18 8 2
8 12 2

1 4 0
16 1 0
14 2 0
11 2 0
9 16 1
9 13 1
15 14 1
4 15 2
14 19 2
7 3 2
