width 20
height 20
@..@.@..@..@@.@.@@@@
..@....@@@..@...@@@.
@..@.@@.@@.@.@.@.@..
@@.@...............@
.....@@.@.@.@@.@.@@@
.@.@.@.@..@...@..@@@
.@@@@@..@@@@.@@@.@@@
...@..@.@@@@@@@..@@@
.@@.@....@.@@@.@.@.@
......@.@...........
.@.@.@...@.@.@.@.@.@
@.@@@..@.@@@@@.@..@@
..@@@.@@@@@@.@.@@...
.@.@..@@@.@...@...@@
...@@..@....@..@.@@@
.@.@..@@@.@@.@@.@@@@
.@.@@...........@@@@
@@....@.@.@.@.@@@@@@
@..@.@...@@@........
@@.@.@@.@@@@@.@.@.@.
10
10 16 0
11 1 0
8 5 0
2 5 0
13 0 1
2 2 1
13 17 1
9 17 2
11 16 2
8 10 2

12 5 0
7 8 0
7 16 0
1 14 0
7 9 1
16 13 1
10 9 1
12 2 2
16 11 2
5 17 2
