width 20
height 20
...@....@..@...@..@.
@@..@@.@@.@..@..@...
...@@@..@...@@@...@.
@.@.@..@@@@@.@.@.@..
.....@.@@.@@....@.@.
@@.@.........@@.....
.@..@.@@@.@.@...@.@.
...@@.@@@..@..@..@@@
.@..@@....@@@..@..@@
..@@@.@.@.@.@@@..@@@
.@.....@..@.@@.@...@
.@@@.@..@......@.@..
@@@@@..@@@.@.@.@@..@
@@@..@.@@.@.@@..@@.@
@@..@..@..@.@.@...@@
@@@...@.@.@....@.@..
@@@@@.......@@...@.@
@@@@@@@.@@@@@@.@....
@@@@@@@@@@@@@@@..@@.
@@@@@@@@@@@@@@@@..@.
10
12 11 0
9 16 0
17 8 0
13 15 0
19 1 1
5 0 1
9 8 1
3 10 2
9 5 2
12 4 2

9 15 0
13 6 0
8 16 0
17 12 0
19 5 1
6 14 1
8 5 1
3 6 2
9 9 2
14 11 2
