width 20
height 20
..@..@@.@.....@....@
.@.@.....@@@@...@@..
.....@.@...@.@@...@.
.@.@@.@.@@......@.@@
..@@.....@@.@@@@..@@
.@.@.@@@..@..@@.@..@
....@@...@..@....@@@
@@.@...@.@.@..@.@.@@
.....@.@@@@@@..@@...
.@.@..@..@.@..@...@.
@...@@.@....@...@@.@
@@.@.@.@.@@...@.....
...@.....@.@.@..@.@.
.@@@@@.@....@.@.@@..
.@.@..@..@.@@....@@.
.....@.@..@@@.@@@...
.@.@...@.@.@@..@.@@.
@.@@.@.@@...@.@..@.@
@.@.@@.@.@@...@@.@..
............@......@
10
2 6 0
16 9 0
5 3 0
8 14 0
6 8 1
13 10 1
10 9 1
0 16 2
4 2 2
6 7 2

16 14 0
0 2 0
18 10 0
6 19 0
2 12 1
2 10 1
15 14 1
17 19 2
14 12 2
4 7 2
