width 20
height 20
@@@@@@..@.....@@..@@
.@.....@.@@.@@@.@.@@
...@.@..............
.@..@@@.@.@.@.@.@@.@
.@.@.@.@.@..@@.@.@@.
.@........@@......@.
..@@@.@.@.@.@.@.@...
.@@@...@.......@@@@.
@.@.@.@.@@@@@.@..@..
........@.@@@...@@@.
@@@.@.@@.....@@@.@@.
.....@@@.@.@........
@.@.@@....@..@.@.@.@
.@@.@..@.@.@@@@@@@..
.@.@.@..@@...@.@.@@.
......@.@..@@.......
.@@.@....@.@.@.@@.@.
@@.@..@@@......@.@@.
.....@@.@.@.@@....@@
@@.@.@.....@@@@.@.@@
10
14 9 0
16 14 0
7 9 0
6 4 0
12 17 1
1 6 1
15 9 1
8 7 2
19 11 2
5 7 2

9 0 0
11 17 0
15 18 0
16 17 0
4 2 1
17 16 1
2 4 1
14 16 2
17 18 2
16 2 2
