width 20
height 20
@@@@.@.@.@.@........
@@@........@@.@.@@@.
@.@@.@@@.@..@.@@@@..
...@..@@.@.@......@.
.@...@@..@..@@.@@@..
@@.@..@@.@.@..@@@.@.
@@@@.@@@@@...@.@....
@@@@@@@@...@.@...@.@
@@@@@@@@@.@.@.@.@.@@
@@@@.@.@..@...@....@
@@.......@@.@..@@.@@
@@@.@.@@..@..@.@....
@@...@..@@@.@.@..@@.
@.@.@@@.@.@.@...@.@@
@....@.......@.@....
..@.@.@.@.@.@...@.@.
@..@.....@@.@.@....@
..@@@.@@.@.....@@.@.
@.....@.@..@.@@.....
@.@.@....@@@@...@.@.
10
7 18 0
19 12 0
3 12 0
17 8 0
7 1 1
10 0 1
17 13 1
19 14 2
0 17 2
4 0 2

7 16 0
11 16 0
12 17 0
6 0 0
1 13 1
3 13 1
4 1 1
14 4 2
17 13 2
19 6 2
