width 20
height 20
@@@@@@@@@@@@@....@@@
@@@@@@@@@@@@@.@@.@@@
...@.@@@@@.@@@@...@@
.@.@.@@@@......@.@@@
.@@...@@.@.@@.@@..@@
.@.@.@.@.....@.@.@.@
.........@@@........
.@.@.@.@.@@@@.@@@.@.
.@..@@..@@@@@@..@@..
..@@@@@..@@@.@.@@.@.
.@..@@.@@.@....@@...
.@@........@.@....@.
@...@.@@.@..@@.@.@..
@@.@.@@@@..@...@..@.
@@@..@.@.@.@@@.@@@@@
@@.@..............@@
@@...@.@.@.@.@@.@@.@
@@@.@.@@@.@@@.......
@@....@@@.@@@@.@.@.@
@@@.@.......@@@@@...
10
7 19 0
14 3 0
13 4 0
0 10 0
13 13 1
5 11 1
14 14 1
2 5 2
4 14 2
1 12 2

16 2 0
19 8 0
8 19 0
10 5 0
3 4 1
19 12 1
12 5 1
11 5 2
19 6 2
16 6 2
