width 20
height 20
@.@@.@.@@....@..@@@@
@..@......@.@@@..@@@
..@.@@.@.@.@..@.@.@@
@.......@...@......@
.@.@.@.@.@.@..@@@.@.
....@.......@.@.....
@.@.@@.@@@.@.@@@.@.@
...@@@@.......@@..@@
@.@.@@.@@.@@.@.@.@@.
@........@@@.....@..
..@@@.@@@.@.@.@.@.@.
.@@@........@..@....
@@@@@.@.@@.@.@@.@.@.
@@@@.@..@..........@
@.@..@.@@@.@.@.@.@..
....@.@.@.@.@.@@@..@
@.@.@.........@@@@..
@@....@@.@.@.@.@@.@.
@@@.@.@...@@........
@@...@@@@...@.@.@.@.
10
1 9 0
3 3 0
4 3 0
16 3 0
5 16 1
4 11 1
7 18 1
1 10 2
7 15 2
3 5 2

19 19 0
3 6 0
5 10 0
15 3 0
5 11 1
17 13 1
12 18 1
5 9 2
11 11 2
3 5 2
