width 20
height 20
@@@@@@@@@@@.@@@@@..@
@@@@@@@@@@@..@@@@@..
@@@@@@@@@@.@..@@@@@.
@@@@@@@@@....@.@@@..
@@@@@@@@.@.@@...@.@.
@@@@@@.......@@.....
@@@@@@@@.@.@...@.@@@
@@@@@@@...@..@.....@
@@@@.@.@.@@@..@.@@@@
.@@@.@...@@@@@....@@
..@@...@..@@@..@@...
.@.@@.@@.@.@.@@@.@.@
......@........@..@@
.@.@.@..@.@.@.@@.@.@
@@@@.@@..@@.@......@
@@@@@@@.@@@..@.@.@..
@@@@@@@@@@..@@.@@..@
@@@@@@@@@.@..@@@@@@@
@@@@@@@@....@@@@@@@@
@@@@@@@@@.@.@@@@@@@@
10
16 6 0
9 3 0
11 14 0
11 18 0
19 3 1
18 11 1
11 3 1
19 1 2
6 8 2
5 12 2

11 14 0
0 11 0
18 15 0
4 13 0
18 16 1
17 16 1
13 10 1
15 14 2
18 0 2
15 8 2
