width 20
height 20
@@@@.@..@......@@@@@
@@@@...@@.@.@@@.@@@@
@@@..@@@...@@@...@@@
@@@@..@.@.@.@.@@..@@
@@@@.@......@....@@@
@@@....@@@.@..@@.@@@
@@@@.@..@.@.@.@.@@@@
@@@@@.@.....@...@@@@
..@...@.@.@..@@..@@@
@.@@@.@..@..@.@.@.@@
........@@@........@
@@.@.@.@@@@@@.@.@.@.
@@@...@@@@@...@@....
@@@@.@@@@@..@@..@@.@
@@.@.@.@@.@...@..@..
@.........@.@@.@.@.@
..@@.@.@.@@.@.......
@...@@@....@@@.@.@.@
.@.@.@.@.@..@..@@.@@
........@..@@@....@@
10
5 19 0
7 3 0
11 0 0
14 7 0
2 11 1
8 17 1
3 10 1
8 9 2
2 18 2
16 15 2

1 15 0
7 4 0
15 7 0
16 15 0
9 1 1
5 3 1
9 0 1
4 14 2
13 9 2
18 14 2
