width 20
height 20
..@@@@@@.@.@@@@@.@..
@...@.@.....@@@....@
@.@@...@.@@@.@.@.@..
...@@.@@.@.....@@.@.
@.@........@.@..@...
..@.@.@.@.@.@@@.@.@@
@..@@.@@@@..@@@.....
.@..@.@.@..@@@..@@.@
...@......@@@.@...@@
.@.@@.@@.@@@....@@.@
..@...@@..@..@@.....
.@..@.@..@@@.@.@.@@.
..@.@.@@..@....@@@..
.@.@.@@@@@.@.@@.@.@.
.....@@@...........@
@@.@.@@.@.@@.@.@@.@.
@@@.....@.@.@...@...
@...@.@......@@.@.@.
..@..@..@.@.@....@..
@.@@..@..@..@.@.@@.@
10
2 1 0
11 3 0
11 18 0
1 19 0
14 4 1
15 8 1
12 15 1
14 15 2
1 3 2
5 11 2

0 8 0
15 19 0
8 2 0
14 14 0
1 3 1
11 12 1
7 15 1
10 14 2
6 8 2
2 14 2
