width 20
height 20
@@@@.........@@@@@@@
@@.@.@.@.@@@.@..@@@@
...@.@..@@@@.@@.@.@@
@.@...@..@@@......@@
....@.@.@...@@.@@@.@
@.@..@.@.@.@@.@.@..@
@.@@..............@@
@@.@.@@@.@.@.@.@@.@@
....@.@.@...@.@...@@
@.@......@@....@@.@@
@@..@.@.@.@@.@.@@..@
@@@@.@.....@@@@...@@
@@@@.@@.@@..@@@@.@.@
@@@.....@..@@@......
@@@@.@@..@@@@@.@.@@.
@@@@@@@.@.@.@.@.@...
@@@@@@........@.@@.@
@@@@@@.@.@.@@.......
@@@@@@.@.@.@..@.@.@.
@@@@@@@..@..@@..@.@.
10
13 17 0
9 4 0
5 10 0
0 4 0
4 2 1
15 2 1
5 4 1
17 3 2
3 5 2
3 13 2

14 3 0
3 9 0
6 5 0
15 3 0
1 2 1
16 13 1
14 6 1
19 14 2
12 18 2
3 5 2
