width 20
height 20
@.@.@..@.@...@@@....
....@.@....@@.@.@.@.
@@.@@...@@@@@.@..@..
@....@@...@.@.@.@.@.
@.@.@.@.@@..........
...@.......@.@.@.@@.
@.@.@@@.@.@@@@@@@...
.......@.@.@.@.@.@.@
@.@.@.@@............
...@@.@..@.@.@.@.@.@
.@...@.@@..@@@@...@@
@.@.@....@.@.@.@.@.@
......@.@@.@........
.@.@.@......@@@@.@.@
..@@@.@.@.@@@@@@@@.@
.@@@@....@@.@.@....@
.@@@@@@.@@......@.@@
..@@@@....@@@.@..@@@
.@@@@@@.@.@@@@@@@@@@
@@@@@@@@@@@@@@@@@@@@
10
13 8 0
5 4 0
8 1 0
5 9 0
17 3 1
5 11 1
8 7 1
16 7 2
10 8 2
13 17 2

14 8 0
2 7 0
11 8 0
7 5 0
11 13 1
13 2 1
17 8 1
6 0 2
8 13 2
0 15 2
