width 20
height 20
@..@...@@@@@@@.@@@.@
..@.@.@@@@@@@...@..@
@......@@@@@..@@.@.@
@@.@@.@.@@..@.......
@....@.....@@@.@.@.@
..@.@@@.@@.@@@@...@.
@..@@@@@.....@.@.@..
@.@.@@@.@@.@...@...@
.....@@.@..@@@@.@@..
@.@.@@...@..@.@.@.@.
.@..@.@.@.@.........
..@.@......@.@.@.@.@
.@....@.@.@.@...@...
...@.@..@....@.@@@.@
.@..@.@@.@@@@.....@@
@@.@@.@.......@@.@.@
........@.@.@.@@....
.@@.@.@.@@.@.@@@@.@.
.@..@@@@.@.@..@@@@..
..@..........@@@@@@.
10
10 7 0
8 11 0
10 17 0
1 8 0
17 1 1
18 18 1
6 9 1
17 12 2
6 2 2
2 8 2

15 3 0
18 3 0
10 18 0
1 11 0
19 6 1
4 0 1
5 10 1
0 11 2
10 6 2
3 8 2
