width 20
height 20
@@@@@.@@@@@@@@@@@@@@
@.@@...@@@@@@@@@@@@@
..@..@@@@@@@@@@@@@@@
@..@.@@@@@@@@@@@@.@@
.@....@@@@@@@@@@..@@
...@.@@@@@@@@@@@@..@
.@@.@@@@@@@@@@@@@.@@
......@@@@@@@@@@@.@@
@.@@.@@@@@@@@@@@@..@
..@@@@@@@@@@@@@@.@.@
.@.@@@@@@@.@.@.@....
.....@@@@........@@.
@.@@..@@..@.@@.@..@.
.@...@..@@@.@@@..@..
...@...@..@..@.@.@.@
.@..@@@..@@.@.....@.
@@.@.@.@.@.@.@.@.@..
.@..............@.@.
...@.@@.@.@.@.@.....
@.@@@...@@..@@..@.@.
10
14 10 0
0 9 0
3 13 0
17 18 0
9 14 1
11 17 1
18 14 1
2 14 2
13 18 2
4 2 2

9 12 0
15 19 0
2 3 0
0 11 0
7 13 1
6 16 1
5 7 1
5 17 2
4 5 2
7 17 2
