width 20
height 20
@.@.@..@...@.@.@.@.@
@.....@.@.@.........
..@.@.....@@.@.@.@.@
@.@.@@.@@....@.@.@..
@@@@@@..@.@.@.@.@..@
@@@@@..@@..@......@@
@@@@@@.@@.@@@.@.@@@@
@@@@.@@@@@@@@@....@@
@......@@.@@@.@.@@@@
@@@@.@@.@.@@....@@@@
@..@.@@.@.@.@.@.@@.@
@.@@..........@@...@
.....@.@.@@@@.@.@@..
.@.@@@@.@.@...@.@.@.
.@@.@@@....@.@......
.....@.@.@@.@.@.@.@.
.@@.@............@@.
@.....@@@.@.@.@.@.@@
@.@.@..@.@..@@......
...@..@@...@@@@.@.@.
10
6 15 0
5 0 0
14 3 0
2 17 0
15 1 1
9 1 1
0 2 1
10 3 2
18 2 2
4 19 2

7 2 0
3 15 0
2 12 0
16 1 0
3 2 1
19 14 1
19 1 1
3 3 2
8 19 2
9 8 2
