width 20
height 20
.@@@.@.@.@@@@@@@@@@@
..@.......@@@@@@@@@@
@.@@.@.@.@@@@@@@@@@@
...@@...@@@@@@@@@@@@
.@..@@.@.@.@.@@@@.@.
@..@@@........@@....
@@.@.@@.@.@.@...@.@@
......@@@@.@@.@.....
@@.@.@@.@@...@..@.@.
..@........@..@@...@
@..@.@.@.@..@..@@.@.
..@..@@..@@..@.@....
.@.@..@@.@..@.@@@.@.
.....@@@..@....@.@..
.@.@...@@@.@.@.....@
..@@.@.@.@.@@@@.@@.@
@.@...@......@.@@.@.
@@@@.@.@@@@@........
.@.....@.@...@.@.@.@
...@.@.....@@...@...
10
17 10 0
0 11 0
19 7 0
13 6 0
14 16 1
6 17 1
7 9 1
3 16 2
15 8 2
1 11 2

12 18 0
11 13 0
18 14 0
13 17 0
0 14 1
14 8 1
2 4 1
2 5 2
17 5 2
11 12 2
