width 20
height 20
..@.....@@......@@.@
.@.@@.@.@.@.@.@@@@..
....@@.......@@@@@.@
.@.@...@.@.@..@@@@..
.@...@@...@..@.@@..@
@.@@.@.@.@@@@@....@@
........@@@@@..@@..@
@.@.@@.@@@@@.@...@..
@.@@...@@@@..@.@@..@
@@.@@.@@@@@.@@..@@..
@@......@...@@@@..@.
@..@@.@@.@.@.@.@.@@.
..@.@.@@............
.@..@@..@@.@.@.@.@.@
...@.@.@....@@@..@.@
.@.......@@@@@@@..@.
@..@.@.@..@.@.@.@@@.
@@..@@@..@......@...
@@@@@@.@...@.@@.@.@@
@@@@@....@..@.......
10
2 2 0
4 16 0
10 0 0
18 8 0
17 10 1
18 14 1
0 2 1
18 12 2
4 5 2
6 0 2

4 10 0
6 19 0
8 5 0
19 11 0
1 16 1
2 11 1
2 1 1
9 10 2
18 4 2
6 5 2
