width 20
height 20
@@@@.@@...@@@@@@@...
@@...@@.@.@.@@@@..@.
.@.@..@@..@..@@..@.@
.@.@@@@.@...@@.@....
..........@......@.@
@.@.@.@.@@.@.@.@..@@
..@@.@......@.@.@@@@
@..@..@.@@.@.....@@@
..@.@..@.....@@.@@@@
@.....@.@.@@...@@@@@
..@.@@...@..@.@@@@@@
@@..@@@.@@@.....@@@@
@@@@.@......@.@@@@@@
.@....@.@@@..@.@@@@@
..@@@..@@.@.@...@@@@
.@....@.@.....@@@@@@
...@@.....@.@.@@@@@@
@@...@.@@..@@@@@@@@@
@..@.@@@..@@@@@@@@@@
..@.....@@@@@@@@@@@@
10
16 3 0
6 6 0
3 4 0
10 3 0
13 7 1
4 2 1
2 7 1
18 3 2
13 14 2
7 11 2

3 4 0
4 4 0
14 4 0
10 10 0
16 1 1
3 15 1
2 16 1
2 4 2
12 13 2
12 7 2
