width 20
height 20
@@.......@.@@@@@.@@@
@@.@@.@.@...@@@..@@@
@@.@.@@.@@.@.@@.@.@@
@......@............
@.@@.@@.@.@@@.@@.@@.
...@.@.....@@@..@.@.
@.@.@@@@.@@.@.@.....
@....@.@@.@.....@.@.
..@.@.......@@.@.@..
@.@...@@.@.@..@....@
..@.@.@..@...@@@.@.@
.@.@@..@@.@.@@@...@@
.@....@....@@@..@.@@
@.@.@.@@@.@.@@.@@@@@
.....@...........@@@
@.@.@.@.@.@.@@.@..@@
...@....@..@...@.@.@
.@.@.@.@.@@.@.@....@
..@@@@@........@.@@@
.@@@@@..@.@.@.@@@@@@
10
15 6 0
14 7 0
3 14 0
9 11 0
6 0 1
10 18 1
7 1 1
13 14 2
17 6 2
14 18 2

4 3 0
6 5 0
16 3 0
17 17 0
7 19 1
19 6 1
15 3 1
4 17 2
17 6 2
13 16 2
