width 20
height 20
@@..@@..@....@.@@@@@
@@@...@...@.@...@@@@
@@@.@@..@..@.@.@..@@
@@..@.@..@@......@@@
@@@.....@@..@.@.@@@@
@@@@@.@@.@.@@@...@@@
@@.........@..@@...@
@.@.@@.@.@.@.@.@.@@.
....@.@.@.@..@......
@.@.........@@@@.@.@
...@.@@.@.@@@@@@@...
@.@....@@@@@@@@@@@@.
@@@@.@..@@@@@@@@@@@@
@@@@@@.@@@@@@@@@@@@@
@@@@...@@@@@@@@@@@@@
@@@@@.@@@@@@@@@@@@@@
@@@@@@@@@@@@@@@@@@@@
@@@@@@@@@@@@@@@@@@@@
@@@@@@@@@@@@@@@@@@@@
@@@@@@@@@@@@@@@@@@@@
10
11 4 0
16 5 0
19 10 0
2 8 0
12 2 1
6 12 1
1 10 1
15 8 2
12 0 2
18 6 2

13 3 0
8 7 0
14 7 0
19 10 0
13 6 1
14 3 1
5 11 1
15 3 2
4 10 2
4 11 2
