width 20
height 20
.@@@.@.@..@@@@@@@@@@
.........@@@@@@@@@@@
@.@@@.@.@@@@@@@@@@@@
@..@@@@.@@@@@@@@@@@@
..@.@@@.@@@@@@@@@@@@
@....@...@@@@@@@@@@@
..@.@@@@...@@@@@@@@@
@@...@...@@@@@@@@@@@
..@@.@@.@.@.@@.@@@@@
.@.@@@....@....@@@@@
......@.@.@.@.@.@@@@
@@.@.@.@..@@@....@@@
....@....@..@.@@..@@
@.@..@.@.@.@.@...@..
...@...@@......@.@.@
@.@..@..@@.@@@.@@...
@@@@.@@@.@.@@@@@@@.@
@@@............@.@..
@@@@.@.@.@.@.@.....@
@@@...@...@@@..@.@..
10
11 9 0
7 10 0
8 16 0
3 4 0
3 5 1
8 12 1
4 1 1
5 19 2
13 14 2
18 16 2

16 18 0
4 14 0
4 8 0
6 1 0
8 7 1
0 4 1
3 17 1
16 13 2
0 8 2
19 15 2
