width 20
height 20
@...@.@.....@....@..
.@.@....@.@@..@@@..@
.....@@@.@.@.@.@.@..
.@.@...............@
.@@@@@.@.@.@.@.@.@@.
......@@..@...@.....
.@.@.@..@@.@.@@@.@@.
@.@....@....@@.@@..@
@..@.@@.@@.@.....@..
@.@.........@@.@@.@.
..@@.@.@.@.@........
@.@.@.@@@@...@.@.@.@
......@@.@.@..@@@..@
@.@@@..@..@@.@.@.@..
@.@@..@.@.@.@......@
..@@@.........@@.@..
@.@@@@@.@.@.@.@.@@@.
@...@@.@...@.....@..
@.@.....@.@@@.@@.@@.
@@..@.@@@@@@@@....@@
10
2 2 0
9 1 0
11 5 0
4 6 0
11 3 1
1 2 1
11 16 1
7 18 2
2 3 2
18 1 2

1 9 0
2 19 0
12 3 0
6 9 0
1 12 1
19 13 1
12 15 1
8 5 2
10 10 2
16 17 2
