width 20
height 20
@@@@@@@@@@@@@@@@@@@@
@@@@@@@@@@@@@@@@@@@@
@@@@@@@@@@@@@@@@@@@@
@@@@@@@@@@@@@@@@@@@@
@@@@@@@@@@@@@@@@@@@@
@@@@@@@@@@@@@@@@@@@@
@@@@@@@@@@@@@@@@@@@@
@@@@@@@@@@@@@@@@@@@@
@@@@@@@@@@@@@@@@@@@@
@@@.@@@@@@@@@@@@@@@@
@@@..@@@@@@@@@@@@@@@
@@@.@@@@@@@.@.@.@@@@
@.@..@@@@@.......@@@
..@.@@@.@@@.@.@.@..@
@.@..@@..@@@.@@.@.@.
...@..@@...@........
@.@@.@.@.@.@.@@.@.@.
.........@..@..@@@..
@.@.@.@.@..@.@.@.@@.
@..@...@@@..........
10
15 11 0
4 16 0
10 16 0
1 19 0
6 17 1
7 18 1
3 17 1
18 13 2
1 14 2
10 15 2

19 19 0
14 18 0
17 19 0
1 13 0
3 17 1
15 19 1
13 15 1
6 16 2
10 17 2
10 19 2
