width 20
height 20
@@.@.@@@..@.@.@@..@@
@....@..@......@.@@@
@@.@@.@...@.@.@...@@
@.......@..@.@@@.@.@
@@.@@.@..@@..@......
@@@@@..@.@@@..@@.@@.
@@@@..@...@.@.@..@.@
@@@.@..@.@@....@....
@@....@.....@.@..@@.
.@@.@..@.@@.@...@.@.
..@..@@@...@@.@...@.
.@@.@@...@.@@@@@@..@
....@@@@@.@.@.@@@.@@
@.@.@@........@@....
...@@.@@.@@.@...@.@@
@.@...@@@..@..@@...@
...@@..@@.@.@....@.@
@.@@@.@.......@.@.@.
..@@@..@.@.@@.@...@.
@..@@@....@@@@..@...
8
2 0 0
11 8 0
2 12 0
8 17 1
14 4 1
4 10 1
15 4 2
11 9 2

4 0 0
6 3 0
18 11 0
15 9 1
16 15 1
19 7 1
8 6 2
18 7 2
