width 20
height 20
..@.@.....@@@@@@@.@.
@...@.@@.@.@@@@@@...
..@.@.@@@...@@@@@@.@
.@.@..@@.@.@.@@@@..@
.....@@......@.@@@..
.@@@..@.@@.@....@..@
...@.@@@.@@..@.@@@..
@.@...@...@.@.@@@@.@
@@.@.@.@.@....@@@@..
@.........@.@..@.@.@
.@.@.@.@.@@@.@......
....@.@.@.@....@.@.@
.@@@@...@..@.@..@...
...@..@.@@.@@..@.@@.
.@@..@........@.....
....@..@.@@@.@..@.@.
@@.@@@..@@@@@@@..@..
@@@@@@.@@@@@@@@.@.@@
@@@@@...@@@@@@@.....
@@@@@@@...@@@@@@.@@.
8
14 13 0
14 5 0
11 7 0
9 4 1
3 7 1
16 11 1
14 11 2
18 1 2

10 13 0
0 15 0
12 14 0
18 4 1
19 18 1
6 9 1
0 4 2
18 10 2
