width 20
height 20
@@@@.@@@@@@@@..@@@@@
..@...@@@@.@..@@@@@@
@..@.@.@@...@...@@@@
..@......@.@.@.@@@@@
.@@@@@.@@....@.@@@@@
..@@@..@.@.@....@.@.
.@.@.@...@..@.@.....
...@...@@.@..@@@.@.@
@@...@......@.@@@@@.
.@.@..@.@.@.@..@.@..
....@@@@.@.@..@..@.@
@@.@.@.@.@..@..@.@.@
@@.....@.@.@.@......
.@.@.@.........@@.@.
..@@@..@@.@.@.@@@@..
.@@@..@..@@@@@@.@.@.
.....@..@.@.........
.@.@.@@.....@.@.@.@.
@...@..@.@.@@@...@..
@.@...@...@@@@@.@@@.
8
9 8 0
11 2 0
3 3 0
8 17 1
13 16 1
6 2 1
0 10 2
5 19 2

13 16 0
13 17 0
0 16 0
1 3 1
14 4 1
19 17 1
3 3 2
2 18 2
