width 20
height 20
....@@..@.@.@...@@@@
.@@....@.....@@..@@@
..@@@.@@@.@.@.@@..@@
.@.@.@@....@@..@@...
......@.@.@@@.@@..@.
@.@@.@...@.@..@.@..@
..@....@@...@.....@.
@@.@.@.@..@.@.@.@...
.@....@.@..@..@@..@.
...@.@@..@...@@..@..
@.@@....@.@@.@.@@@@.
...@.@@@.........@..
.@..@.@.@.@@.@.@@@.@
@..@........@@@@@@..
.@.@@.@.@@@..@@@@@@@
...@...@....@@@@@@.@
@.@.@.@@@.@.@@@@@...
......@@...@..@@.@.@
.@.@.@@.@.@@@.@@....
..@@@............@.@
8
18 19 0
17 6 0
18 11 0
0 8 1
12 17 1
5 10 1
15 0 2
19 16 2

13 19 0
1 10 0
12 11 0
1 9 1
6 10 1
12 8 1
7 10 2
19 16 2
