width 20
height 20
@.@.@@@@@.@....@..@@
......@@@...@@.@@..@
@.@@@.....@.@@..@.@.
@..@@@@@.@..@.@@....
..@.@.@.@.@.@.@.@@@.
.@..............@.@.
@..@.@@.@.@@.@@.....
.@..@@@@....@@@.@@.@
...@@@.@@.@.@@.@.@..
@@......@@.@.......@
.@@.@.@@....@@.@.@..
.@@@@.@@@@.@....@..@
..@@...@@...@.@.@.@.
.@..@.@.@.@@@@@@....
...@@@@.@.@.@.@.@.@@
@@..@...........@...
.@.@..@.@.@.@.@.@.@.
.....@...@.@@.@..@..
.@.@.@@@....@@@@...@
@...@....@.@@@@@.@.@
8
11 18 0
13 14 0
9 15 0
13 4 1
14 5 1
13 11 1
17 5 2
12 11 2

5 15 0
7 13 0
18 19 0
0 12 1
10 15 1
11 4 1
16 6 2
7 6 2
