width 20
height 20
..@.......@...@.@@@@
@...@@@.@@.@.@...@@@
..@..@@@@@...@.@@@@@
@..@@.@.@..@...@@@@@
..@@.....@.@.@@.@.@.
@.@.@.@.@.@.........
......@.....@.@.@.@.
@.@.@@@@.@@.@@@..@@.
@@......@@@@@.@@..@.
@@@.@.@@@@@......@@@
@@@@...@@@@@.@.@.@@@
@@@@@@..@@@@@@@@@..@
@@.@.@.@.@..@@.@..@@
...........@.@.@.@@@
@.@.@.@.@@.@.@....@@
@@...@@@@@.....@.@@@
@@@.@@@....@@.@.@@@@
@@@@@...@.@@@....@@@
@@....@..@.@..@.@@@@
@@@.@..@....@..@@@@@
8
9 16 0
3 2 0
17 8 0
16 15 1
1 6 1
4 2 1
18 5 2
0 4 2

3 1 0
5 13 0
4 6 0
13 15 1
15 1 1
5 4 1
10 15 2
1 1 2
