width 20
height 20
..@@..@..@@@@@.@..@@
.@.@.@.@.@..@...@..@
..........@...@...@@
@.@.@@.@.@.@.@..@...
...@@@@.....@@@.@.@.
@.@@@@@@.@@..@...@..
..@@@@....@.@@@.@.@@
.@@@@..@.@.@.@@.@..@
..@@.@@...........@.
.@@@.@.@.@@.@.@.@...
.@@@...@..@@.@..@.@@
@.@@.@...@@@.@@@.@@@
@.@...@@@.@@..@...@@
..@@@..@@....@.@.@.@
@.....@..@.@@.......
@.@.@..@...@.@.@@.@.
..@@@@...@......@@.@
@.@...@.@..@@.@.....
..@.@.@@.@.@..@@.@@.
@....@......@...@...
8
4 19 0
12 12 0
8 4 0
0 16 1
8 6 1
5 2 1
8 11 2
8 7 2

11 16 0
0 10 0
3 15 0
12 8 1
15 1 1
9 4 1
8 11 2
14 0 2
