width 20
height 20
@.@.@@@.@...@@@@.@@@
.....@...@@..@@@....
@.@.@@@.@.@.@.@..@@@
@@...@..@.......@@@@
@@@.@.@.@.@.@.@..@@@
@@@........@.@.@.@@@
@@@@.@.@.@@........@
@@@@.@..@..@@.@@.@..
@@@.@.@@.@.@@.@@@@.@
@@@............@....
@@@.@.@@@@.@.@.@.@.@
@..@@@@@..@@@.@...@.
@@.@@.@..@@@....@...
.......@....@.@.@@.@
@.@.@@@..@.@...@@.@.
..@.@.@.@.@.@.@.....
@@..............@@.@
..@.@.@.@.@.@.@...@@
@....@@.@@...@@@@..@
@.@.@@@@@@@.@@@@@@..
8
0 15 0
17 6 0
2 13 0
17 15 1
2 12 1
7 17 1
11 4 2
6 16 2

17 1 0
15 13 0
18 12 0
18 16 1
15 3 1
4 18 1
13 9 2
16 11 2
