width 20
height 20
@@@@@@@.@.....@@@...
@@@@@@@...@.@.@@..@@
@@@@@@@@@.@@...@@.@@
@..@@@@@..@@@@.@...@
@.@.@@@@@..@..@.@.@@
.......@..@.@.@.@...
.@@.@@@.@.........@@
@.........@@@@.@.@.@
.@.@.@@.@.@.@.@.....
...@.@.@.......@@.@.
.@@.@@..@@.@.@.@@@..
.@.....@....@@..@@@.
.@.@@@.@@@.@@@.@.@@.
@.....@.@@@.@....@.@
@@.@.@......@@.@....
@@@....@@@@...@.@@.@
@@@@.@@@....@.......
@@@@@....@.@..@.@.@.
@@@@@@.@.@.@.@...@@@
@@@@@@..@..@..@.@@@@
8
6 12 0
7 13 0
17 16 0
6 18 1
4 7 1
14 16 1
12 15 2
9 2 2

9 8 0
7 14 0
6 15 0
13 6 1
18 16 1
8 17 1
14 7 2
4 13 2
