width 20
height 20
.@.@.@@.@.@@@@@.@.@@
........@..@@.@.@..@
.@.@@.@...@.......@.
@..@@.@.@.@@.@.@@.@.
.@.@.@.@.@.@.@..@...
..............@@@@.@
@.@.@.@@@@.@@...@@@@
...@......@@..@@@@@@
@.@@@.@@.@@..@@@@@@@
..@@@@..@.@.@.@@@@@@
.@.@@.@..........@@@
@.......@.@.@.@.@@@@
..@.@@.@@@.@..@@@@@@
.@@@@.@@@@..@..@.@.@
.@@........@..@.....
@@@@.@.@.@..@...@.@.
@@@@@@@.@@.@..@@@@..
@@@@........@...@.@@
@@@..@.@.@@...@....@
@@..@@@@@@@@@@..@.@@
8
10 5 0
11 15 0
4 7 0
0 4 1
3 5 1
15 1 1
0 14 2
5 14 2

5 6 0
11 15 0
7 7 0
7 0 1
9 3 1
4 18 1
5 10 2
8 14 2
