width 20
height 20
...@....@@@.........
.@.@.@.@@...@.@.@@.@
@....@@.@@.@..@@@@..
@.@.@@@.@@@.@.....@.
.@..@.........@.@.@.
..@..@.@.@.@.@..@@..
.@.@.@.@..@@.@.@..@.
........@.@.@.@.@...
@.@@.@.@@@........@@
....@@..@@@.@.@.@.@.
@.@..@.@@@...@@@....
@@..@.@.@.@@..@@@.@.
@@.@.........@@@.@..
@@@..@@@@.@@..@...@.
.@.@.@.@.@..@.@@@...
...........@.@.@.@.@
.@@.@.@.@@.....@.@@@
.@@@...@@@.@.@......
....@@@@@@@@@..@.@.@
.@@...@@@@@@@@..@@.@
8
13 7 0
1 7 0
13 3 0
13 1 1
4 6 1
6 4 1
0 7 2
19 5 2

0 5 0
14 6 0
0 16 0
8 5 1
16 0 1
7 4 1
19 5 2
15 5 2
