width 20
height 20
@......@@.@.@.......
..@.@@.@....@@.@.@.@
@..@.@..@@.@.@@...@@
..@@.@@......@.@.@@@
@..@.@.@.@@@......@@
..@@......@@@.@.@...
@.@..@@@.@.@.@.@.@.@
@@..@.@.@@.......@@@
@..@.......@.@.@.@.@
@@...@.@.@..@@@.....
...@..@@@..@.@.@.@.@
.@..@@@@@@.....@@...
@..@....@..@.@@...@.
..@@@.@.@.@@@..@.@.@
.@.@@.@@.@.@.@.@....
.@.............@.@@@
@..@.@@.@.@.@@......
.@..@...@@@@...@.@.@
.@.@.@.@@@@@.@@@@...
.....@..@@@@@@@@@@.@
8
17 16 0
13 7 0
5 10 0
10 11 1
12 4 1
18 1 1
12 3 2
2 4 2

10 15 0
16 7 0
16 8 0
7 2 1
11 9 1
0 18 1
17 18 2
7 16 2
