width 20
height 20
@@@@@@..@@@@@@@@@@@@
@@@@@..@@@@@@@@@@@@@
@@@@@.@..@@@@@@@@@@@
.@@@....@@..@.@@@@@@
..@.@.@...@....@@@@@
@.....@.@@..@@.@@@@@
@.@.@.@@@@@...@@@@@@
...@.@..@@@.@..@.@.@
@.@@.@.@.@.@.@......
..@............@.@.@
@.@@@@.@.@.@@.@.@...
@.@.@@@.@..@@.@..@.@
..........@@@@.@..@@
@.@.@.@.@..@.....@.@
..@@...@..@..@@.@...
.@@@@@@@@...@...@.@.
@.@@...@@.@@..@@...@
@...@@...@@@@..@.@@@
@@.@.@@.@.@@.@...@@@
@..............@@@@@
8
5 4 0
3 4 0
8 19 0
5 12 1
6 1 1
16 9 1
6 7 2
6 19 2

4 12 0
8 19 0
0 3 0
17 14 1
6 1 1
17 8 1
1 13 2
4 19 2
