width 20
height 20
@@........@@@@@@@...
@@.@@.@.@.@@@@@@..@.
@@@...@@....@@@..@..
@@@@@..@@.@.@@@@..@@
@@@@@.@.@@.@.@.@.@@.
@@@@.............@..
@@@@@.@@.@.@@.@.@@@.
@@@...@..@..@@...@..
@@..@.@@.@.@.@.@..@.
@..@.@.@@.....@.@.@.
.@.......@.@@@......
...@.@.@.@@..@@.@.@.
@@@@@.@@@@.@.....@.@
.@...........@.@....
...@@.@.@@.@@@@..@.@
@@.@.@.@@.@@@..@@...
............@@..@@.@
.@.@.@.@@@.@...@.@..
..@@@@@@@@@@@@.@...@
.@@@@@@@@@@@@@...@.@
8
14 7 0
13 9 0
7 0 0
3 8 1
16 19 1
19 4 1
12 4 2
6 11 2

2 14 0
3 8 0
11 3 0
14 19 1
12 12 1
16 8 1
12 17 2
8 6 2
