width 20
height 20
.@...@......@......@
..@.@@@@@.@...@@@@@@
@....@@@@@@.@..@.@.@
..@.@@@@@@@.@.@@....
@..@@@@@@@@@.....@.@
..@.@@@@.@@.@@@@.@..
@.....@..@....@.@..@
@.@.@.@.@.@.@@...@..
@@@@...........@...@
@@@@@.@.@.@@.@@@@.@@
@@@@@@@@..@.@@@@@@@@
@@.@.....@.....@@@@@
@@.@.@.@.@.@.@.@.@@@
......@..@..@..@.@@@
@.@@.@@@@..@..@...@@
@@...@@.@@..@...@@@@
...@.@.....@@@@..@@@
.@..@.@@@.@@@...@@@@
..@...@.@@.@.@.@.@@@
.@@@@.............@@
8
9 8 0
11 15 0
4 2 0
2 2 1
10 6 1
17 8 1
3 15 2
7 6 2

16 13 0
12 12 0
7 6 0
1 2 1
7 9 1
15 4 1
16 5 2
16 12 2
