width 20
height 20
@@@.@..@@...@.@.@.@@
@@@..@...@@.@.@.@...
@@..@..@@.........@.
@@@..@...@.@.@@@.@..
@@@.@@@.@@..@@@...@.
@@..@@@..@@@@@@@.@.@
@@.@@.@.@@.@.@.@....
.................@.@
.@.@.@@.@.@@.@@.@..@
..@@@@@@@@.@@..@@@@@
.@.@.@@.@.....@@@@@@
.........@.@@..@@@.@
.@.@@.@@.....@..@...
@....@..@.@@@@.@.@.@
@@.@..@..@..........
@@@..@.@.@@@.@.@@@@@
...@.@.....@@..@....
@@...@@@.@.@@@...@.@
@.@@.....@..@.@@..@@
.....@.@.@@@.....@@@
8
0 9 0
13 10 0
5 18 0
6 11 1
17 8 1
15 8 1
15 2 2
19 1 2

4 18 0
13 10 0
10 6 0
19 16 1
9 13 1
9 7 1
15 19 2
2 5 2
