width 20
height 20
@@@@@@@@@@.@@@.@..@@
@@@@@@@@@........@@@
@@@@@@@@@@@@.@@@..@@
@@@@@@@@@@@@@@@..@@@
@@@@@@@@@@@@@@.@.@@@
@@@@@@@@@@@@@.....@@
@@@@@@@@@@@@@@.@.@.@
@@@@@@@@@@@@@@@.....
@@@@@@@@@@@@@@@@.@.@
@@@@@@@@@@@@@@@@..@.
@@@@@@@@@@@@@@@.@...
@@@@@@@@.@@@@@....@@
@@@@@@@..@@@@@@.@.@@
@@@@.@.@.@@@@@@@...@
@@........@@@@@.@@.@
@@@@.@.@@@@.@......@
@@@@@..@.@....@.@.@@
@@@@@@.....@@..@....
@@@@@..@.@...@..@.@.
@@@@@@..@..@.@@@@@..
8
7 19 0
16 4 0
11 16 0
12 19 1
18 14 1
17 10 1
15 14 2
17 9 2

15 11 0
15 1 0
14 6 0
17 0 1
16 4 1
18 6 1
14 0 2
17 18 2
