width 20
height 20
@@@@@@@.@.@.@.@@@@@@
@@@@.@..@......@@@@@
@@.....@@@.@@.@.@@@.
@@@.@@.@.@@@....@.@.
@@@@.......@@.@.....
@@@@@.@@.@.@@@@@.@.@
@@@@..@.@.@..@@...@.
@@@.@.......@.@@.@..
@@....@.@.@........@
@.@.@.@@.@@@.@.@.@..
.....@......@..@@..@
.@@.@.@.@.@.@@.@@@..
.@.......@..@..@@@.@
.@@.@@@@.@@@.@@.@...
@@@...@...@@......@@
@@@.@@.@.@.@.@@.@...
@@..@@..@......@@.@.
@..@@.@..@.@.@@@@@@@
@@......@...@@.@@.@.
@@@.@@@..@@.........
8
3 13 0
6 3 0
4 10 0
15 14 1
14 14 1
7 18 1
12 16 2
12 17 2

11 19 0
14 19 0
1 17 0
3 14 1
9 16 1
19 19 1
7 4 2
19 9 2
