width 20
height 20
@@@@@@@@@@@@@@@@@@@@
@@@@@@@@@@@@@@@@@@@@
@@@@@@@@@@@@@@@@@@@@
@@@@@@@@@@@@@@@@@@@@
@@@@@.@@@@@@@@@@@@@@
@@@@...@@@@@@@@@@@@@
@@@@@.@.@.@@@@.@@@@@
@@@@.......@@@...@@@
@@@@@.@.@.@.@@.@@.@@
@@@@@@@@...........@
@@@@@@@@@.@@.@.@@.@.
@@@@@@.@@@@@@@.@....
@@@.@...@@@@@.@.@.@.
@.@..@.@.@.........@
....@@.....@.@@.@.@@
@.@@.@.@.@.@@.@@@@.@
.....@..@.@.....@...
.@.@...@....@.@@..@.
..@.@.@.@@.@.@@..@@@
.@..............@@@@
8
17 17 0
3 13 0
8 19 0
5 18 1
9 8 1
0 17 1
15 16 2
4 13 2

14 9 0
3 13 0
9 9 0
15 19 1
17 12 1
4 17 1
11 13 2
18 16 2
