width 20
height 20
@@.@..@.@..@@@......
@@.@.@....@@@@@.@.@.
@.....@.@..@@@@@...@
..@@@.@@..@@@@@.@@..
@.@...@.@..@@@....@.
@@@@.@@.@.@.@.@.@...
@@@.......@.....@@.@
@@@@.@@.@...@@.@.@..
@@.@@.@@@.@@@@@@...@
@@.......@@@.@...@.@
@@.@@@.@.@@..@@@..@@
...@@@.@.@..@.@..@@@
@.@.@.@.@.@...@@..@@
............@....@.@
@.@.@.@.@.@.@.@.@..@
...@...@..@@@@.@.@.@
@@.@@.@.@...........
.....@....@.@.@.@.@.
.@@@.@.@.@...@...@..
.@....@@@@@.@..@@@.@
8
16 15 0
2 19 0
4 17 0
4 13 1
15 16 1
11 11 1
17 12 2
0 3 2

1 2 0
11 17 0
0 11 0
11 10 1
3 4 1
7 6 1
9 15 2
4 7 2
