width 20
height 20
....................
....................
......@........@.@..
...........@........
....................
...@.@..@....@......
.@................@.
....................
.........@....@.....
...@..@...@..@......
.......@............
@@@.....@...@.@.....
.......@........@...
....@......@........
.......@....@.......
....................
...@..............@.
.....@..@...........
......@.@@..........
........@@..........
4
5 0 0
0 19 0
0 4 1
16 9 2

19 14 0
5 18 0
14 19 1
3 11 2
