width 20
height 20
..@@@...............
..@..........@......
.........@.....@....
...@................
................@...
..@.........@....@..
.........@..........
....................
@@............@.....
@......@.@..........
......@........@.@..
@............@......
....................
....@....@......@...
.........@.....@....
..@........@......@.
.....@...........@..
@@..................
@...................
@...................
4
13 0 0
16 2 0
12 16 1
19 17 2

18 18 0
17 13 0
5 0 1
19 9 2
