width 20
height 20
@@@@......@@........
@@@@.......@......@.
@@............@.....
@.........@.......@.
........@...........
..............@...@.
.......@............
..........@....@.@..
...@.......@........
..@.@..@..@.........
....................
.@.@................
.....@.......@......
..@......@..........
....................
......@.@.....@.@...
.......@...@.@...@..
....@...............
.........@.@........
........@..........@
4
10 14 0
8 18 0
7 2 1
12 9 2

1 5 0
19 2 0
6 5 1
13 8 2
