width 20
height 20
....................
.............@......
..@..@..@........@..
...............@....
.@....@....@........
................@...
....................
...@...@......@.....
...........@........
..............@.@...
..@.......@.........
............@....@..
......@.............
............@..@.@.@
....@......@.@......
.....@..............
..........@.........
..@...........@.....
......@.........@...
....................
4
8 5 0
9 11 0
12 0 1
1 0 2

5 19 0
19 1 0
2 0 1
11 15 2
