width 20
height 20
.........@@.....@@@@
..............@.@@@@
.......@.........@@@
...@.........@....@@
@.......@...........
..........@....@....
............@...@.@.
....................
...@...@......@....@
..........@.@.....@@
........@......@..@@
....@...............
....................
.@...@..............
............@.......
.........@..........
@@@@......@..@......
@@@@...@.@.....@..@.
@@@@................
@@@@................
4
0 13 0
7 5 0
8 2 1
9 11 2

1 8 0
6 6 0
8 2 1
15 3 2
