width 20
height 20
@@...@@@...........@
@@...@@.............
...........@..@.....
...@................
@..................@
@...................
@@..........@...@...
...@.....@...@......
......@.......@.....
@...............@...
..........@@........
..........@.....@...
.......@............
@......@.........@..
.........@.@........
........@....@......
....@...........@...
@..@......@.@.......
.....@........@.....
@@.............@@@..
4
9 13 0
15 14 0
14 6 1
1 4 2

16 0 0
19 17 0
2 0 1
18 18 2
