width 20
height 20
@.................@@
.........@..@.....@@
...@................
.......@...@........
.....@.......@......
..@...@..........@..
............@.......
....................
@...@..........@...@
@..@......@.....@...
......@......@......
...@...............@
................@.@@
.@......@......@....
.@@.................
................@...
...........@@.......
...@....@...........
....................
....................
4
4 16 0
16 7 0
6 19 1
13 12 2

13 9 0
18 14 0
12 5 1
1 16 2
