width 20
height 20
.....@.@...........@
....@.........@.....
.......@.......@....
...................@
......@.............
........@....@......
.@@.................
...@.@..........@.@.
.........@...@.....@
........@...@.......
....................
...........@........
....@.....@.@.......
..@..............@..
.....@..............
..@......@..........
....................
......@.............
....................
.........@.........@
4
13 19 0
16 0 0
13 4 1
13 9 2

13 19 0
10 6 0
5 10 1
11 8 2
