width 20
height 20
........@.....@@@@@@
..............@@.@@@
..................@@
@...................
....................
...........@........
@.....@...........@@
...............@...@
...@........@.@.....
....................
.....@@@............
..@.......@..@..@.@.
..............@.....
.....@...@..........
.............@.@....
...@.@.@.@.........@
....................
..@......@..........
............@.@.....
@@@.................
4
4 14 0
3 2 0
7 2 1
7 7 2

11 1 0
19 9 0
9 9 1
11 2 2
