width 20
height 20
....................
....................
........@...........
....@.@.......@..@..
.......@.@..........
............@.@..@..
......@.............
.........@..........
...@................
....@......@.@......
....................
....@.........@.....
........@.......@...
.....@......@.......
...........@...@.@..
................@.@.
...........@........
.......@.@.....@..@.
....@.........@.....
...........@........
4
1 1 0
10 5 0
2 15 1
4 4 2

8 11 0
7 5 0
18 0 1
9 16 2
