width 20
height 20
....................
...............@....
............@.......
...@................
....@.....@.........
.@.............@....
.................@..
......@.@...........
.............@...@..
....@...............
....................
.............@......
...................@
.....@......@.@.....
....@...............
.........@......@...
..@......@.....@....
...........@........
..@......@..........
....................
4
4 0 0
7 6 0
3 11 1
8 14 2

7 2 0
10 6 0
14 18 1
18 0 2
