width 20
height 20
...................@
........@...........
............@.......
...@................
......@...........@@
............@.....@@
.@...@..@..@........
...............@....
....@.............@.
........@..@@.@.....
..@..........@.@....
...@.....@.@........
.....@..............
....................
......@....@........
...@...........@....
......@.........@...
............@.......
...@......@......@..
.@...............@..
4
10 2 0
16 5 0
0 19 1
12 16 2

0 18 0
3 14 0
18 9 1
1 1 2
