width 20
height 20
....@@@@.......@....
.....@@......@......
.@..................
..........@.........
.....@..............
...@.@@.@.........@.
..............@.....
.......@...@.@......
....................
.@.................@
......@............@
..........@...@.@..@
....@...............
...@..........@.....
........@...@.......
......@..@..........
.....@...........@..
...@......@....@....
..@@................
..@@.......@........
4
17 18 0
18 7 0
18 14 1
19 2 2

15 6 0
10 7 0
2 5 1
16 2 2
