width 20
height 20
@..................@
@................@@@
.........@....@@@@@@
...@..@..@....@@@@@@
.................@@@
.....@.......@.....@
..@............@....
....@...............
...@......@.........
.......@....@.......
....@............@..
.@..................
...............@@...
....................
@......@.@@.........
@.............@....@
@..................@
@...@.......@.......
....................
..................@.
4
4 12 0
13 17 0
18 0 1
18 5 2

15 18 0
1 1 0
14 4 1
1 17 2
