width 20
height 20
@@................@@
@..........@......@@
............@.......
.@.......@..........
.......@......@.....
....................
......@.....@..@....
...@.....@..........
......@.............
@@...@...@......@...
@@.@....@.....@.....
@@@.................
@@@@.@.........@...@
..........@......@.@
...................@
....@....@..........
..@.........@....@..
.......@.......@..@.
..@.......@...@@....
..............@@@...
4
15 13 0
13 0 0
9 4 1
6 17 2

10 8 0
10 3 0
11 5 1
1 5 2
