width 20
height 20
....................
............@..@....
....................
....@........@......
.....@..............
..............@....@
..@..@...@.......@@@
@.....@...........@@
@...@.@..........@..
..@....@............
....@@....@........@
...................@
......@.....@..@....
...................@
..@.......@.........
..@.................
.............@......
....................
....@...@...........
...@@...@@.........@
4
13 5 0
12 17 0
6 15 1
6 19 2

14 8 0
17 13 0
16 17 1
16 0 2
