width 20
height 20
................@...
.....@....@.........
...........@........
@..@................
@..........@.....@..
..@.................
....................
....@...@....@......
...........@......@.
.................@..
...@...@..@...@.....
..................@.
....@.@.............
....................
.....@...@..........
......@.............
........@...........
........@.....@.....
....................
....................
4
2 3 0
1 4 0
8 2 1
6 18 2

2 7 0
1 10 0
5 17 1
16 5 2
