width 20
height 20
...................@
....@..............@
.......@......@.....
....................
.....@..@......@....
....................
.@...........@......
..........@.@..@..@.
...................@
.............@.@..@@
..................@@
..@.............@@@@
...........@....@@@@
.............@..@@@.
....@...@.......@@..
...@................
..@....@...@..@.....
....................
.................@..
....................
4
15 2 0
1 7 0
3 3 1
12 3 2

10 11 0
4 11 0
14 4 1
0 18 2
