width 20
height 20
....................
.@.................@
.....@............@@
...................@
....@........@......
.@.........@........
........@.....@..@..
.....@@....@......@.
..............@.....
....@........@.@....
......@...@.........
.@..................
..@.........@......@
.............@.@...@
................@...
.......@.@.@..@.....
....................
...@................
....................
.........@@.....@...
4
8 16 0
6 5 0
18 10 1
15 4 2

8 16 0
18 11 0
1 0 1
16 17 2
