width 20
height 20
.......@....@@.@@...
.........@..........
....................
.......@........@...
..@......@..........
............@.......
...@...@.......@....
....................
.............@.@....
.......@............
...@....@...........
............@...@...
...@.........@.....@
........@...........
.....@..............
.@..................
...........@..@.....
......@.....@..@....
....................
...@@..............@
4
5 5 0
18 18 0
4 18 1
13 18 2

12 18 0
5 1 0
16 1 1
3 1 2
