width 20
height 20
@@..................
@@....@...@.........
@@..................
............@...@...
......@......@......
....................
.......@.........@..
...@.....@.@........
.....@.......@......
....................
..........@.........
....@..........@..@.
...........@....@...
....................
.................@..
..........@.@...@...
......@.............
@...................
@@@.............@...
@@@.............@@@@
4
10 13 0
19 8 0
6 10 1
2 11 2

12 1 0
10 4 0
11 9 1
16 1 2
