width 20
height 20
....................
............@...@...
....@..............@
.........@..........
...@................
......@.....@...@.@@
........@..........@
..@...........@.@..@
...@...@....@.......
.........@..........
.......@............
...@..@...@..@......
..............@.....
........@...........
....................
....................
.@..@......@...@....
.....@.@..........@.
........@...........
....................
4
6 10 0
18 8 0
10 8 1
15 1 2

6 3 0
8 8 0
19 19 1
11 5 2
