width 20
height 20
@.....@@....@.......
......@@............
..............@...@.
@....@..@..@........
............@.@.....
...@.....@..........
....@...........@.@@
..............@@@...
.......@.@....@@@...
.....@........@@@@..
.......@..@....@@@@@
.........@.@.@.@@@@@
....@............@@@
............@.......
..........@.........
........@..@.....@..
..@............@....
................@...
.................@..
@...................
4
6 16 0
19 16 0
16 15 1
4 4 2

14 1 0
7 2 0
16 15 1
5 6 2
