width 20
height 20
..............@..@@@
.................@@@
...........@......@@
...................@
..@....@.....@@@....
@............@@@....
@.......@..@........
....................
..@......@........@.
.....@.@............
..............@.....
....................
.........@....@.....
.............@...@..
......@.............
.........@.@.@@.....
.@........@...@.....
....@...@...........
......@........@..@@
..................@@
4
10 0 0
17 12 0
16 17 1
18 11 2

1 19 0
6 6 0
19 12 1
15 12 2
