width 20
height 20
...............@@@@@
...............@@@@@
@...@..@........@@@@
@............@..@@@@
@...@....@.....@@@@@
.....@.....@....@@@@
@...............@@@@
................@@@@
.@......@........@@@
....@.........@..@@@
......@...@..@...@@.
....................
.@..................
..@.....@...@.......
...@..@.............
.............@......
.......@.@...@......
...............@...@
....................
..............@@@@..
4
7 11 0
15 8 0
15 2 1
11 17 2

3 12 0
1 19 0
5 14 1
7 3 2
