width 20
height 20
.........@..........
.........@....@.@...
.........@..........
..@...............@@
...@..@.......@...@@
....@.......@.....@@
....................
......@....@........
.@.......@..........
.....@......@.......
......@.........@...
.......@...@........
...@.....@.....@....
................@...
..@...@.@..@..@.....
....................
......@.....@...@...
..........@.........
....................
..............@.....
8
11 6 0
17 12 0
19 19 0
14 2 0
15 4 0
8 3 0
8 18 0
12 10 0

11 6 0
12 19 0
14 3 0
10 10 0
8 19 0
19 18 0
16 2 0
12 11 0
