width 20
height 20
.....@..............
...........@........
...............@....
.................@..
........@..@........
..............@.....
.............@.....@
.@.@...@........@...
......@...@.........
.......@.@..........
...@................
.....@..@.@.@.....@.
...........@..@.....
.@..............@..@
.........@........@.
..............@@....
.....@..............
@@.........@...@....
.....@..............
@.......@@..........
8
10 2 0
2 0 0
13 11 0
2 6 0
12 0 0
3 19 0
5 13 0
11 13 0

14 16 0
13 18 0
16 6 0
19 14 0
14 17 0
19 18 0
3 6 0
14 0 0
