width 20
height 20
....................
....@.@.............
.....@..............
.........@.....@....
.....@.......@......
....................
......@.............
....................
........@.@.........
......@.....@.......
.@...@..........@...
....................
.........@.@...@..@.
.....@..............
.......@............
........@.@.........
....@..@.........@..
....................
....................
........@@@@..@@@...
8
2 14 0
2 10 0
13 1 0
3 2 0
16 17 0
10 0 0
13 3 0
3 19 0

19 0 0
18 17 0
17 0 0
4 6 0
3 7 0
11 1 0
13 7 0
4 13 0
