width 20
height 20
............@.......
.......@........@...
........@...........
....................
..........@...@.....
.......@.......@....
................@...
........@.@.@.......
...@.....@....@.....
..@..@..............
.......@.........@..
...@....@...........
....................
.@@.................
.@........@..@@.@...
.........@..........
......@.@...........
..............@.....
......@.....@.......
....@@..............
8
14 19 0
0 8 0
19 10 0
8 0 0
13 5 0
13 10 0
18 5 0
11 7 0

1 0 0
17 1 0
0 3 0
18 18 0
14 5 0
3 10 0
15 6 0
7 6 0
