width 20
height 20
...........@.@@.....
..........@@........
.....@..@.@@........
...@...........@..@.
..........@.........
....@...............
.....@....@.........
....@...............
...............@....
.........@..........
..@.@.....@..@......
......@.@......@....
....................
.............@......
........@...@.......
....@...............
@.....@.............
@....@.@.@.........@
@..................@
@@@.............@@@@
8
1 10 0
15 4 0
2 1 0
5 1 0
7 6 0
3 9 0
9 11 0
11 12 0

4 4 0
3 10 0
16 8 0
1 9 0
2 17 0
14 4 0
7 11 0
9 13 0
