width 20
height 20
@@@................@
@@@...@.............
@...@..........@....
@@@@................
@@@@....@@..........
@@......@@........@.
@@..................
......@@.@..@..@....
................@...
...........@........
....................
..............@.@...
..........@..@...@..
.@...@@.............
......@........@....
........@@@@........
........@@.@....@...
......@@@@..........
@.....@@@@..........
@..@..@@@@@.@.....@@
8
14 7 0
7 2 0
4 3 0
9 9 0
2 12 0
8 3 0
2 5 0
19 17 0

13 9 0
14 19 0
4 12 0
9 9 0
19 18 0
14 10 0
3 6 0
19 6 0
