width 20
height 20
@...........@..@....
...............@....
@........@.@...@@...
@@@.................
.....@..............
.......@.......@....
@@.@........@.....@.
@................@..
....@...@.......@...
.............@......
...@.@........@.....
...............@....
.........@.@........
..........@...@....@
....................
....................
.......@.......@....
........@...@.....@.
...@.............@..
@.....@@@...........
8
9 18 0
16 18 0
16 4 0
9 16 0
4 10 0
4 3 0
2 13 0
7 17 0

2 1 0
3 0 0
0 8 0
4 0 0
7 14 0
18 13 0
10 14 0
1 2 0
