width 20
height 20
....................
.........@..........
..............@.....
.......@........@...
....@...............
.................@..
..@..........@..@.@.
.....@...@..........
....@.......@...@...
...............@....
.....@.........@..@@
.@..@....@.........@
.............@...@.@
....................
...........@...@....
..............@@....
@...................
........@...........
...............@....
.........@@@@.......
8
11 3 0
12 5 0
17 0 0
19 2 0
1 15 0
7 8 0
5 6 0
2 10 0

8 0 0
11 6 0
5 3 0
9 5 0
15 3 0
10 8 0
10 10 0
4 10 0
