width 20
height 20
....................
....................
.................@.@
....................
...@................
.@..@....@..@....@..
....@.@.@...........
............@....@..
....@.@...@....@....
....................
.........@.....@....
....@..@............
....................
.......@............
..@...........@.@...
.......@..@.........
....................
....................
@...................
@@.....@............
8
13 15 0
19 14 0
3 11 0
1 17 0
0 13 0
4 19 0
5 6 0
7 1 0

0 10 0
0 2 0
18 1 0
15 0 0
11 16 0
9 9 0
8 2 0
10 14 0
