width 20
height 20
.....@....@@........
....................
@.........@...@....@
@@...............@.@
...........@..@....@
....@.@.....@@@....@
.....@.............@
...@..@..@....@..@..
....................
............@....@..
.......@.@..........
@.@...........@.....
......@.........@...
........@...@.......
.@..@............@..
.............@......
......@..@@.........
.............@..@...
............@.@.....
............@.......
8
12 17 0
15 15 0
12 2 0
10 1 0
16 2 0
17 5 0
11 19 0
5 8 0

17 13 0
1 0 0
13 0 0
11 15 0
16 8 0
19 17 0
3 8 0
1 7 0
