width 20
height 20
................@...
.@..................
..@.@.......@.@.....
@...................
......@...@.........
@...................
@..........@........
@.....@.@.@..@...@..
....................
.....@..............
...........@........
.........@..@.......
....................
.....@..@...........
....................
.......@...@....@...
.@@............@....
@@@@....@...........
@@@@..@.............
@@@@...........@@@..
8
0 1 0
18 13 0
19 12 0
4 10 0
6 17 0
8 15 0
7 8 0
7 1 0

8 3 0
18 5 0
19 16 0
15 1 0
4 10 0
0 14 0
5 19 0
0 0 0
