width 20
height 20
@@@....@.........@@@
....................
....................
.............@......
....@...........@...
.......@......@.....
...@...............@
..@.@...@..@.....@@@
................@@@@
...@..@.........@@@@
........@..@.......@
..@.@.............@@
..................@@
..........@..@......
....@....@..........
@..........@.....@..
@@..................
@@@...........@...@.
@@@@@..@...........@
@@@@@..............@
8
3 14 0
5 5 0
8 16 0
17 16 0
19 2 0
13 12 0
3 13 0
1 3 0

18 6 0
5 3 0
17 13 0
12 1 0
5 2 0
0 3 0
7 6 0
18 18 0
