width 20
height 20
......@@@@@..@@.....
....................
.............@......
@.................@.
.....@..@........@..
......@.......@.....
....................
..@.....@.......@...
....................
..@.................
...@...@.@..........
.......@............
......@.....@@@.....
.....@......@@@.....
.......@....@@@.....
@..@.....@..........
....................
........@...@.......
....................
................@...
8
2 16 0
8 1 0
7 3 0
5 0 0
1 7 0
14 3 0
10 10 0
5 14 0

2 16 0
17 17 0
10 3 0
0 7 0
18 17 0
11 0 0
17 6 0
3 2 0
