width 20
height 20
...@................
........@..@........
.....@...@.........@
..................@@
...................@
..@..@.............@
....................
....................
.........@.....@....
.@.........@...@....
....@...............
......@...@.@.......
....................
.............@......
....@...@.........@@
...................@
..........@.@.......
............@.......
...........@@.......
...........@....@...
8
7 14 0
6 10 0
18 4 0
11 2 0
17 18 0
15 0 0
18 5 0
8 4 0

19 0 0
16 17 0
18 4 0
16 12 0
6 15 0
9 4 0
8 18 0
8 4 0
