width 20
height 20
....................
....@...............
..@.............@...
.............@......
.@.....@...@....@...
...................@
.....@.............@
............@..@....
.@..@.....@.......@.
............@.@.....
.............@..@...
....................
....@..........@....
......@.......@.@...
..@.................
.........@......@...
.....@........@..@..
.............@@.....
............@@@.....
.......@...@@@@..@..
8
2 6 0
15 4 0
1 2 0
10 16 0
17 11 0
16 17 0
17 0 0
5 14 0

4 5 0
15 4 0
2 3 0
3 18 0
0 19 0
0 5 0
4 2 0
6 15 0
