width 20
height 20
...................@
.........@..........
...@.@....@.....@...
..@..............@..
...@................
..............@.....
....................
....................
@@....@.....@@@.....
..@..........@@@....
......@.....@@@@....
........@....@@...@.
...@..@.......@.....
..@.................
........@...@.......
....................
..@.............@...
......@..@@.@.......
.....@@@.@@@......@@
.....@@@..@@@......@
8
14 17 0
14 4 0
4 3 0
10 12 0
13 7 0
6 3 0
16 3 0
12 7 0

4 1 0
10 7 0
1 18 0
10 12 0
6 3 0
12 2 0
8 15 0
10 4 0
