width 20
height 20
...................@
..@.................
........@...........
..............@..@..
........@...........
.@@...........@.....
....................
............@.......
.@...@..@..@...@.@..
....................
...@............@@@@
...........@....@@@@
.................@@@
......@..........@@@
...@........@....@@@
..@.....@...........
................@.@.
.......@............
...@.......@.......@
..............@.....
8
1 15 0
14 10 0
2 7 0
0 16 0
13 11 0
12 8 0
10 4 0
2 14 0

17 16 0
4 0 0
18 1 0
17 18 0
0 19 0
11 9 0
3 16 0
0 9 0
