width 20
height 20
....................
.........@..........
........@....@.@....
.......@...@..@.@...
...@......@.........
@...................
.....@..@....@......
.......@.......@....
..............@..@..
...@.@..............
........@...........
@......@...@.......@
@@.@.........@.@....
....................
..@..@..............
@.........@......@..
................@...
....................
....................
...................@
8
7 18 0
5 0 0
12 18 0
9 10 0
16 0 0
7 1 0
2 6 0
8 12 0

10 14 0
11 16 0
17 7 0
1 15 0
4 0 0
12 2 0
12 15 0
18 11 0
