width 20
height 20
................@...
....................
......@..@.@.......@
....@...............
............@.@.@...
.........@..........
....@...............
...........@....@...
....................
.@.@.@.@@.@.......@.
....................
....@..........@....
..@.......@.........
............@......@
....................
........@......@....
..@@........@.......
......@.@........@..
..@................@
..@@@.........@...@@
8
15 9 0
15 14 0
7 2 0
19 7 0
5 16 0
15 12 0
3 7 0
8 19 0

3 5 0
17 11 0
7 3 0
18 6 0
4 13 0
1 1 0
11 11 0
8 19 0
