width 20
height 20
....................
..............@...@.
...@................
.......@.@........@.
....................
.........@..........
...@................
.......@....@.....@.
...............@....
.....@.@............
...............@....
............@.......
....................
.........@..........
.@..............@...
@...................
..................@.
...@.....@..@.......
.................@..
....................
8
12 10 0
5 17 0
2 11 0
5 7 0
0 12 0
15 4 0
14 8 0
16 13 0

11 9 0
7 5 0
18 19 0
6 9 0
6 2 0
4 16 0
13 12 0
1 7 0
