width 20
height 20
....@@..............
....@............@..
..@..............@.@
............@...@@@@
................@@@@
.........@...@...@@@
...@....@......@.@@@
.............@.....@
..@.@...............
...................@
......@............@
@..........@.@......
......@.............
....................
.@.......@.....@....
...@.........@......
....@.@............@
.................@@@
..........@....@.@@@
.@@..............@@@
2
3 9 0
17 8 1

17 15 0
10 8 1
