width 20
height 20
....................
....................
..........@.@.......
....@...........@...
.......@...@........
.@................@.
..............@.@...
.@...@...@..........
...@........@..@....
....................
......@...@.........
.................@..
.....@..............
.@.....@.@......@...
....................
............@..@....
....@...............
....................
....................
@.@@................
2
9 10 0
19 10 1

13 1 0
0 7 1
