width 20
height 20
@...................
.....@......@.......
..@.................
..........@.........
.....@..............
@@...........@.@..@.
@@...@..............
@@.....@..@.@.....@.
.@@.................
...........@.....@..
.....@....@@@..@....
.@........@@........
..@.................
.....@.............@
...@........@.@.@..@
....@....@.@.....@..
...@................
...............@....
......@.............
............@.......
2
11 12 0
6 7 1

13 6 0
7 3 1
