width 20
height 20
.........@@@@.......
............@......@
...@................
@...............@...
.....@............@.
....@.....@.........
........@.......@...
..@.@...............
............@..@....
..........@.@.@...@@
..@.@.......@.......
...............@...@
...@..@......@.@@..@
.......@............
....@@......@....@..
...@@...@...........
..........@..@....@.
......@..@..........
@@@................@
@@@...@@...........@
2
5 15 0
13 19 1

6 11 0
14 19 1
