width 20
height 20
...........@........
.....@..............
...........@..@..@..
..@.......@.........
.@....@........@....
.............@......
............@......@
..@........@..@.@...
...@..............@.
..@...........@.....
..................@.
.......@....@.......
...@................
......@.............
.@.@.....@.......@..
..........@.....@...
...........@...@...@
@.......@..@......@@
@....@..@..@@.......
................@@..
2
10 17 0
18 16 1

9 16 0
17 16 1
