width 20
height 20
..............@.....
....................
..........@.........
...@...@.@....@.....
....................
.....@.@..@..@......
....@...............
@...................
@........@...@......
@..............@....
....@.......@.......
....................
...........@........
...@..@.....@.......
.........@.......@..
..@....@............
.....@......@.......
....@.........@..@..
......@.....@@.@....
....@...............
2
4 2 0
12 6 1

5 8 0
7 10 1
