width 20
height 20
..........@@........
...@.@..............
.........@..@.......
..@.................
.@...............@@@
.................@@@
...@..@..........@@@
........@........@@@
..........@......@@@
................@@@@
@.......@....@...@@@
@@....@...@.....@.@@
@...........@.......
@@........@.........
@@..................
....................
..@..@.....@@.......
...........@@@......
...........@@@..@...
@....@@@..@@@@@.....
2
6 1 0
7 1 1

19 19 0
8 3 1
