width 20
height 20
...................@
....@.....@.........
.............@@.....
....@........@......
.....@.........@....
.........@..........
.@.@..........@.....
..@............@....
......@@.@..........
....@.........@.....
............@.......
......@.@...........
..................@.
............@...@..@
.........@@.........
....................
......@......@..@..@
.@..........@.......
.........@..........
....................
2
11 14 0
17 7 1

2 1 0
15 18 1
