width 20
height 20
.............@....@@
..................@@
.@..................
...................@
...................@
........@.........@@
...@..............@@
..........@......@@@
......@.........@@@@
....@.........@.@@@@
.........@......@@@@
..@................@
....@.@@....@.......
...@...@.....@......
...............@....
.........@.@........
.....@..............
....@........@......
...@.@..@.......@...
....................
2
14 12 0
1 5 1

9 9 0
14 7 1
