width 20
height 20
...........@........
.........@..........
................@...
....@.@...@.........
....................
.@.@........@@..@...
.........@...@......
.....@..@...........
..@.................
.........@.....@....
..@.@...............
..........@...@.....
...@..@........@...@
........@....@..@...
....................
.....@...@....@.....
..@........@...@....
.......@..........@.
.....@......@.......
...................@
2
15 8 0
2 0 1

19 15 0
2 12 1
