width 20
height 20
..................@@
....................
........@...@...@...
....................
....@.............@@
@@........@.........
@@..@.@.@...@.......
..@.................
.......@.@....@..@..
....................
....................
....@........@.@....
@@.....@......@.@...
@@..................
........@......@....
....................
.......@@...........
.....@.....@...@....
..............@.....
.@..................
2
2 17 0
14 1 1

6 17 0
7 11 1
