width 20
height 20
@@@........@........
@.................@.
....................
.@.@........@.......
...@...@...@........
.@..........@.......
......@............@
...@....@.....@..@.@
.........@...@.....@
......@...........@@
................@..@
......@.............
...@@@@..@..........
...............@....
.....@..............
....@...............
.......@..@.....@...
..............@.....
@........@..@......@
@@.................@
2
2 13 0
16 15 1

17 0 0
18 15 1
