width 20
height 20
@........@......@@@@
....@.....@@....@@@@
.....@........@@@@@@
@@.............@@@@@
@........@......@@@@
......@....@.....@@@
....................
@@@@@..@........@...
.@.@..@.@...........
............@....@..
....@.........@.....
......@...@......@..
.......@............
..@.................
....@..@...@........
....................
.....@..@.........@.
...........@.@......
..@......@..........
@..................@
2
5 4 0
16 19 1

8 10 0
8 7 1
