width 20
height 20
..........@@......@@
@.................@@
............@.....@@
..................@@
....@.@.............
...@......@......@..
..............@.....
..@.....@...........
...............@....
..@......@..........
..............@....@
..........@.@.......
......@............@
........@.@....@....
.........@..........
........@..@.@....@.
...@................
....................
....@..@............
....@.......@....@@.
2
12 9 0
6 0 1

0 18 0
0 4 1
