width 20
height 20
...................@
....................
....................
..............@.@...
....@........@...@..
.........@........@.
.......@............
.@..........@..@....
....................
....@.........@...@.
...@....@...........
...........@........
............@.......
.....@..............
....@........@...@..
...@......@.........
....................
......@.............
..@........@....@...
....................
2
17 17 0
3 7 1

1 6 0
11 8 1
