width 20
height 20
.........@........@@
....@......@......@@
@.....@.@....@......
@........@..........
@..........@....@...
.............@.....@
....@@..............
..@...@.............
..@@....@.....@.....
....................
....................
........@...........
.......@.....@....@.
.....@..............
........@...........
@@.@.@..............
............@.......
......@...@.........
.................@..
...@.......@........
2
1 9 0
19 3 1

2 11 0
13 15 1
