width 20
height 20
@@@@@@@@....@@@@@...
@@@@@@@@............
@@@@@@@@@...........
@@@@@@@@@...........
@@@@@...............
@@@@@@..........@...
@@@@.............@.@
@@@......@.......@@@
.................@..
@.....@...@.........
@........@.@........
................@...
..............@.....
....@....@..........
.@........@.......@.
........@..@...@....
.....@........@.....
.............@..@...
........@...........
@....@@.............
2
8 13 0
19 0 1

19 4 0
11 3 1
