width 20
height 20
@........@..........
.............@.@....
.......@............
.@..............@...
.....@.@............
....@.......@.......
.................@..
@...............@...
.....@.....@...@..@.
@...................
@..............@....
...........@.@......
.@..@...............
.....@....@.........
..........@.........
.@....@..@.......@..
...@............@...
.............@@.....
..........@@@@@.....
......@@..@@@@@@....
2
10 1 0
14 16 1

2 16 0
7 5 1
