width 20
height 20
@@@....@@...@.......
....................
....@...@.....@.....
...............@....
.....@..............
...........@.....@..
.............@......
..@......@....@....@
....................
.......@........@...
...@.....@....@@....
..@.................
....................
.@...@........@.....
............@...@...
........@.@.........
..@.@..@.@.......@..
....................
....................
..@..........@@@....
2
6 9 0
19 8 1

16 8 0
2 13 1
