width 20
height 20
....................
...............@....
......@.@.@.........
.............@......
..@.............@...
........@...........
....@.@.@.......@...
....................
............@.......
......@.............
....................
...@..@.............
....@..@.......@....
.........@..........
....................
.@....@...@.....@@..
....@.........@.....
....................
@...........@.......
..@.................
2
12 11 0
19 3 1

15 10 0
6 16 1
