width 20
height 20
.................@@@
....@...........@.@@
...@.........@....@@
........@..@......@@
...............@....
.@...@..@....@......
...........@..@.....
....................
@..@..........@.....
@.......@...........
@................@..
..............@...@.
...@...@............
...............@....
.@........@..@......
.....@..............
.@........@.....@...
.....@...@...@......
....................
...................@
2
15 10 0
4 6 1

6 19 0
19 15 1
