width 20
height 20
....................
.......@....@.......
...@................
@.........@.....@...
@@..................
@@...@..............
.....@..@...........
............@.......
........@.....@.....
....................
....................
..@............@....
..@..........@......
....@.@...@.........
@....@..........@...
............@.......
......@.@.....@.....
.........@......@...
.@..................
....................
2
17 13 0
6 4 1

15 16 0
4 7 1
