width 20
height 20
....................
.....@..............
..@.....@.@...@.....
...........@.@.....@
.....@..............
....@.....@..@......
@...........@...@...
..........@.........
....................
.........@....@.....
.@.@......@.........
.....@.............@
......@..@..@...@...
..............@.....
.............@......
.......@..........@.
...........@........
......@.......@.....
.....@.@............
..............@@....
2
8 7 0
13 19 1

8 7 0
13 16 1
