width 20
height 20
@.......@@........@@
@@..........@.....@@
......@.......@...@@
..........@.........
...@@...............
.........@....@.....
.............@......
.@........@...@.....
....@...............
.............@......
....................
....@.@..@.........@
..@.................
.@.....@.......@....
..@........@........
....................
.......@.@...@.....@
...@....@.......@..@
...................@
...................@
2
4 2 0
12 12 1

13 2 0
12 18 1
