width 20
height 20
@@@@@@..@.@.@.@.@@.@
@@@@@@@............@
@@@@@@..@@@.@.@@.@..
@@@@@.@..@...@....@@
@@@@....@@@.@.@.@..@
@@@.@.@@@@....@.@.@.
@@.....@@@.@@@.@.@@.
@@@.@.@.@.@......@..
@@@@........@@.@..@.
@@@@@@@@.@.@.@@@.@..
@@@.@@.@@.@@...@.@.@
@@..@..@..@@@.@.....
@@@..@..@..@...@.@.@
@@@@..@...@.@.@.@...
@.@..@@.@@.......@.@
..@@.@..@@@.@@.@....
.@.@..@......@.@.@.@
...@@...@.@.@@@@@...
@.@.@@.@.@@..@@@@@.@
.......@....@@@@@...
1
8 16 0

15 4 0
