width 20
height 20
@@@....@@@.@@@@@...@
....@.@@@@..@.@.@.@.
.@@@.@.@...@........
........@@...@.@.@.@
.@.@.@.@.@@.@.@@@...
.@@@@..@.@.....@..@.
.@@@@@.....@.@@@@.@@
@@.@@@.@@@@.@@.@.@..
...................@
@.@@@.@.@.@.@.@@@@..
.....@.@.@@.@.@.@..@
@.@.@..@.@@..@....@@
.@@..@.....@..@.@..@
....@..@@.@@.@@@..@@
.@@.@@...@@@@.@@@..@
...@...@@.@@...@..@.
.@.@.@.....@@.@.@...
@.....@.@.@.......@.
@@.@.@..@@.@.@@@.@..
@@..@..@@@......@..@
1
15 1 0

7 16 0
