width 20
height 20
@@@@@@@...@@.@.@@@..
@@@@.@..@.@..@.@@@.@
@.@..@.@.@.@....@..@
...@........@@.@.@..
@.@.@@.@@.@........@
.....@@..@@.@@.@.@..
@.@.@.@@.@.@.@@.@@.@
@@...........@......
@..@.@.@.@.@@.@.@@.@
@@..@@@@@...@...@.@.
@@.@@..@.@.@@@@.....
@@.@.@......@...@@.@
@@@....@.@.@@@.@@@@@
@@@@.@.@..@@@@.@@@@@
.@@..@@@@.@@@@..@@@@
.@.@.@.@.@.@.@.@@@@@
................@@@@
@.@.@.@.@.@.@@.@@@@@
@@@@@@...@.@.@@.@@@@
@@@@@..@........@@@@
1
14 19 0

15 19 0
