width 20
height 20
@@@@@...@@@@@..@.@..
@@@.@.@..@@@.@...@@.
.......@.@@@...@.@..
@@@.@@..@.@@.@@.@.@.
@....@.@............
@@@.@....@.@.@.@.@@.
.....@.@..@...@@@.@.
@.@.@..@@.@.@.@@....
@..@@@...@.@@@.@@.@.
..@@...@@..........@
@...@@.@@.@.@.@.@.@.
..@.@.@.@..@.@@@@@..
@@..@.....@@.@@.@..@
.@@..@@.@.@.......@@
..@@.@@@@...@.@.@.@@
@.@@@.@.@@@..@@@@.@@
.........@.@@.@@...@
.@.@.@.@....@.@.@.@@
.@@.@...@@.@@.......
.....@.@@.....@@.@.@
1
17 15 0

1 9 0
