width 20
height 20
@@@........@@@..@...
@@..@.@@.@@.@..@.@.@
@@@.@.@@@@...@......
@@@..@.@...@..@.@@.@
@@.@.....@@..@.@.@.@
.....@.@..@.@.......
.@.@.@@..@.@.@.@.@.@
.@.@@@@@........@...
@@@@@@@@@@.@.@@@@.@.
.@.@@@@@.@..@@@@@.@.
.@..@@@@...@.@.@.@.@
...@.@@@@@..........
.@....@@...@.@.@.@.@
.@.@.@.@@.@..@.@@@@@
..@.....@@..@....@@@
.@.@.@.@@@@@.@@.@.@.
....@...@@@.........
.@.@@@.@.@.@.@.@@.@.
.@..@......@..@@@@@@
..@..@.@.@...@@@@@@@
1
3 2 0

17 2 0
