width 20
height 20
@....@@@@@@@@@@@@@@@
..@@.@@@@@@@@@@@@@@@
@@.@.@@.@@@@@@@@@@@@
.........@@.@@@@@@@@
@.@@.@.@.@....@@@@@@
.@....@...@@@..@@@@@
.@.@@@@@.@.@@.@.@@..
......@@@........@.@
.@.@.@.@@@.@.@.@@...
@.@.....@@.@@.....@.
...@@.@.@.@...@.@..@
@.@.@@......@..@..@.
.......@@@.@..@@@.@.
.@.@.@.@@.@@.@.@....
..@..@@....@....@.@.
.@@@....@.@..@.@.@..
..@..@.@..@@..@...@.
.@@@..@@@...@@..@...
.@...@....@@@@@.@.@.
@@@@.@@.@..@@@..@..@
1
12 12 0

12 12 0
