width 20
height 20
@@@.@..@@@....@@@@..
.@...@..@.@.@..@...@
..@@...@..@@..@.@@.@
.@.@.@@..@..@.@.@...
.......@..@...@.@@.@
@@.@.@...@..@@......
@@@@@..@@.@.@.@.@.@@
@@.@.@..@.@......@@@
@......@....@.@@@@@.
.@.@.@..@.@@.@@..@..
....@@@@........@.@.
.@.@@@@@@.@.@.@.....
@..@@@@@...@.@.@.@@.
@@.@.@.@@.@..@.@.@..
@....@..@@@@.@.@.@@.
.@.@.@.@.........@..
...@....@.@.@.@.@.@.
@@.@.@@...@@@@@@....
@@..@@@@@...@@@.@.@@
@@.@@@@@@.@..@......
1
6 14 0

15 11 0
