width 20
height 20
@@@@.@@@.@..@..@@@@@
@@....@@.@.@.@.@@@@@
@.@.@...........@@@@
...@@@.@@.@.@.@..@@@
@@..@...@..@@@..@@@@
@@@..@.@@.@@@..@@@@@
@@.@.@@.@@.@.@.@@@@@
@...............@@@@
@@.@.@.@.@.@.@.@@@@@
@@@@@..@.@@..@@@@@@@
@@@@..@@..@@@@@@@@@@
@@@@@.@@.@@@@@@@@@@@
@@@@@@@@@@@@@@@@@@@@
@@@@@@@@@@@@@@@@@@@@
@@@@@@@@@@@@@@@@@@@@
@@@@@@@@@@@@@@@@@@@@
@@@@@@@@@@@@@@@@@@@@
@@@@@@@@@@@@@@@@@@@@
@@@@@@@@@@@@@@@@@@@@
@@@@@@@@@@@@@@@@@@@@
1
9 3 0

2 3 0
