width 20
height 20
@@@@@@......@.@.@.@@
.@@@@@@.@.@.........
..@@@@.@.@.@.@.@.@.@
@.@@..........@.@...
@.@..@.@.@.@.@...@@.
...@..@...@.@@@.@...
@.@.@.@@@@...@....@.
......@...@.@@@.@..@
.@@.@..@@...@....@.@
..@@.@....@.@.@.@...
.@.....@.@@.@..@@@.@
@@@.@@..@@@..@@.@..@
@@@.@@.@@..@..@..@@@
@@@@@..@.@.@.@@.@.@@
@@@@@@.....@.@.....@
@@@@@..@.@@.@.@@@.@.
@@@@@@@.............
@@@@@@@@.@@.@@.@.@.@
@@@@@@@@@.....@...@@
@@@@@@@@@@.@.@@@.@@@
1
0 8 0

0 1 0
