width 20
height 20
@....@.@.@..@...@..@
.@.@.......@.@.@.@..
....@@.@.@@..@.....@
.@.@@@@.@@.@...@@.@@
..@@.@.......@...@@@
.@@....@.@.@.@.@..@@
..@@@@..@..@@.@.@.@@
.@@@...@@.@@......@@
.....@...@...@.@.@..
.@.@..@.@.@.@@@@@.@.
..@.@@.@.......@@.@.
.@......@.@@@@.@....
...@.@@@@@@.@...@.@.
@.@...@..@...@.@@@..
.@@@@...@.@.@@.@@@@.
....@.@......@..@@..
@.@@.@@@.@.@@.@....@
.....@@.@...@.@@.@..
.@@@.....@.@@.@@@.@.
@....@.@..........@.
1
19 12 0

7 6 0
