width 20
height 20
.@..........@.@..@..
..@.@@@.@.@.@..@.@.@
@.....@@@.@@.@.....@
..@.@@.@.@.@...@.@..
.@.@.@.......@..@@.@
.@.....@.@@.@@.@.@.@
...@.@.@.@.@@.....@@
@.@.@.@@@...@.@@@.@@
@......@.@.@.@@...@@
@@.@.@.........@.@.@
@@@@@..@@.@.@.@.....
@@.@.@@....@@@@@.@.@
.....@.@.@..@.@@.@..
@@.@....@@@...@.@.@.
.@.@.@@@.@.@.@@.....
..@@.........@.@.@@.
@....@.@.@.@...@@@@.
.@.@..@.@...@.@.@@..
....@...@.@..@...@.@
.@.@@@.@@.@.@..@....
1
16 3 0

14 16 0
