width 20
height 20
.........@@@@@@@@@@@
.@.@.@@.@@@@@@@@@@@@
..@@@....@@@@@@@@@@@
.@.@.@.@@@@.@@@..@.@
...@.....@......@..@
@@.@.@.@@.@.@.@.@@..
@@.@..@.@...@@..@..@
@...@.....@.@.@.@@..
..@@@@.@.@@@...@.@.@
@.@.@.@.@.@@.@......
..............@@.@@.
@.@.@.@.@.@@.@.@@.@@
..@@@@@@@..@.......@
@.@@....@.@..@.@@.@@
..@.@.@@@@.@@.@.@.@@
@...........@.@.....
..@.@.@@.@.@@...@.@.
.@.@.@..@....@@..@..
...@.@.@.@@.@@@@..@.
.@@.........@@@..@@@
1
16 3 0

2 6 0
