width 20
height 20
@@@.@@.@....@.@@....
@@.......@.@.....@.@
...@.@.@@@@@@.@@@...
.@@.@.@@.@.@.@.@@.@.
...................@
@.@.@.@@.@.@.@@.@@..
...@...@@@@.@@@@@@.@
@@@@@.@@@@@..@@.@@..
@@@@.@...@@@....@..@
@@@@...@..@.@.@@.@..
@@@@@.@.@@@........@
@@@@....@.@.@.@.@@..
@@@.@.@.@....@..@..@
@@...@....@.@@@.@.@.
@@@.@@@.@.@.@@@@....
@@......@@.@..@@@@.@
.@@.@.@......@.@....
....@.@.@.@.@....@.@
.@.@..@..@.@.@.@..@.
..@@@..@.@......@...
1
5 6 0

19 11 0
