width 20
height 20
@..@...@@@@.@@@.....
..@.@.@@@@...@@.@.@.
@......@@@@.@.@..@.@
..@.@.@.@@......@...
@.@@.@.....@.@@.@.@.
.......@.@..@@@@@..@
.@@.@@..@.@..@@.@.@.
...@.@@@@..@@.@.@...
.@.@.@.@@@........@@
@.......@@@@@.@.@...
..@@.@.@.@.@@..@@.@.
@.@.@........@..@@@.
.....@.@.@.@..@@.@..
@.@@@@@.@@@@.@.@...@
@@@..@@........@.@..
@.@@....@.@.@@....@.
.....@@..@..@..@.@@@
@.@.@@@@@.@..@@...@@
...@.@@@@...@..@@..@
.@....@@..@...@...@@
1
7 14 0

4 12 0
