width 20
height 20
@..@..@@........@.@@
..@@@..@.@.@@@.@@..@
@.@.@.@@..@@...@@.@.
..@......@@@@.@.....
.@.@.@.@@@@.@@@@.@@.
......@@.@..@.@.@...
@.@.@.....@.......@.
..@..@.@@...@@.@@..@
@.@@@@@...@.@@@...@.
@@@@@@@@@..@....@...
@@@@@@@...@.@.@..@.@
@.@@@@@.@.@.@@@@..@@
@..@@@...@@.@@@@@...
@.@.@.@@.@@..@.@@.@@
............@.....@.
.@.@.@.@.@@@..@.@...
..@.@@..@@@.@.@@@@.@
@...@@.@.@..@.@.@.@@
..@@......@.......@@
@.@@@.@.@@..@.@.@@@@
1
6 12 0

13 9 0
