width 20
height 20
.@..@............@@@
.@@..@.@.@.@@.@.@@@.
....@...@@..@@@..@..
@.@...@@..@@@@..@.@.
@@..@....@..@@.@....
@..@.@@@.@.@.@@.@@@.
@@@@...@........@.@.
.@@.@@...@@.@.@.@.@.
.@.....@.@.@.@..@.@.
...@.@.@@@...@@.....
@@..@@@....@@...@.@.
...@@@@.@@..@@@.@@@@
.@...@.@.@.@.@@.@.@@
@..@...........@..@@
@@.@.@.@.@.@@.@@@.@.
@..@@.@@@....@@@....
@@@.@.@.@@@.@.@.@.@.
@..................@
@@.@.@@.@.@.@.@@@.@.
@@..@@@@@@@..@......
1
17 10 0

10 9 0
