width 20
height 20
.@...@@@@@@.@.@@@@@.
...@@.@@@@.....@@@..
@.@.@..@@.@@.@..@.@.
......@....@@..@....
@.@.@.@.@@..@.@.@.@.
...@@..@...@.......@
@.@.@.@.@.@.@.@@.@..
.@@.@..........@@..@
..@.@.@@.@.@.@@@.@.@
@....@@.@..@@.......
..@@@@....@..@.@.@.@
.@.@@@@.@@..@..@..@@
.....@@@@@@..@.@@.@@
@@.@..@.@@.@.@.@..@@
@@@.@........@@.@..@
.@...@.@@@.@@.@...@@
.@@.@.@.@.......@.@@
..........@.@.@.@...
@.@.@.@.@.@.@@@@..@.
...@@@...@@....@@..@
1
12 8 0

16 10 0
