width 20
height 20
@@@@@@@@@@@@@@@@@@@@
@@@@@@@@@@@@@@@@@@@@
@@@@@@@@@@@@@@@@@@@@
@@@@@@@@@@@@@@@@@@@@
@@@@@@@@@@@@@@@@@@@@
@@@@@@@@@@@@@@@@@.@@
@@@@@@@@@@@@@@@@...@
@@@@@@@@@@@@@@@@@.@@
@@@@@@@@@@@@@@@@@..@
@@@.@@@@@.@.@@@@.@..
.@...@@@@....@@....@
..@@..@@@.@.@.@@.@@.
.@...@@@@@..........
..@@.@@.@.@.@.@.@.@.
.@.@.@.......@.@@@..
.......@@.@@...@@..@
.@.@.@...@..@@.@.@.@
..@@@@.@.@.@@..@....
.@.@.@@......@.@.@.@
......@@.@.@@...@..@
1
19 13 0

19 12 0
