width 20
height 20
.....@.@.@.@.@@@@@..
@.@@...@......@@@.@.
@@...@...@@.@.@@@...
@@@.@.@.@@@@..@@..@.
@@.....@@@@@@.@.@..@
@..@.@@.@@..@.....@@
@@..@@..@..@..@@.@@.
@@.@.@.@.@..@@...@..
...........@..@.@.@.
@.@.@.@.@.@@@.......
@..@@@...@.@.@.@@.@@
@@...@.@......@@@@@.
@@@.@.@.@@.@.@@@@...
@@.@@.@.@@@...@@.@@.
@........@..@.....@.
@.@@@.@.@.@.@.@@.@@.
...@@@.......@......
@.@.@@@.@.@@@..@@.@.
.....@@@.....@...@@@
@@.@.@@..@.@@@@.@@@@
1
5 12 0

2 18 0
