width 20
height 20
@@@..@.@@@@.@.@.@.@@
@@..@....@......@..@
..@...@.@..@@@.@..@.
.@.@.@.@@.@.@.@.@...
.....@............@.
@.@@...@.@@.@.@.@..@
...@.@..@@@.@@.@.@.@
@.@.@..@.@.@.@......
....@.@........@@.@@
.@@..@..@.@@@.@@..@.
...@.@.@.@.@.@..@...
.@@@@..........@..@.
.....@@.@@@.@.@@@.@@
.@.@...@.....@@@....
@.@..@.@@.@.@.@.@.@@
@.@@@.@@@@......@@@.
....@.@@@@@.@.@@.@..
@.@....@@@@@.....@.@
..@@@.@.@.@.@.@@....
.@............@@@@.@
1
6 13 0

9 11 0
