width 20
height 20
@@@@@@@@@.@@@.@.@@.@
@@@@@@@@...@........
@@@@@@@@@.@.@.@@.@.@
@@@@@@@@@.....@@@...
@@@@@@@@@@@.@@@@@@.@
@@@@@@@@@@..@@@@@@@@
@@@@@@@@@@@.@.@@@@@@
@@@@@@@@@@.....@@@@@
@@@@..@..@@.@.@@@@@@
@@@@@.@@.@.@@..@@@@@
@@@@..........@@@@@@
@@@@@@.@.@@.@.@@@@@@
@@@@@@@....@.@.@.@@@
@@@@@@@@.@.@.@....@@
.@@.@@@@@......@.@@@
.@@.@@.@.@.@@.@@.@@@
...........@@@@@@@@@
.@.@@.@.@.@@@@@@@@@@
..@.@.@@@..@@@@@@@@@
.@@...@...@@@@@@@@@@
1
9 3 0

11 3 0
