width 20
height 20
..@........@..@@.@.@
.@..@.@.@.@.@..@....
...@@..@....@.@..@@@
.@.@.@..@.@...@@....
.@....@..@..@....@.@
.@.@.@.@@..@..@.@@@@
..@....@.@..@@@.....
.@.@.@....@@@..@@@@.
.@...@.@.@..@.@.@@.@
@@.@..@@@.@........@
....@..@@...@.@@.@..
.@.@.@@.@.@..@@..@.@
@..........@@@@@@...
@@.@.@.@@.@...@@.@.@
....@@@@.@@.@@@@..@@
.@.@@@......@.@.@..@
..@.@.@@.@@.@.....@.
@........@....@.@@..
..@.@.@.@@@@.@..@@.@
.@...@...@....@.....
10
12 17 0
4 9 0
2 3 0
16 1 0
7 18 0
9 1 0
0 15 0
10 4 0
19 19 0
5 1 0

7 15 0
16 6 0
18 15 0
17 12 0
6 6 0
6 13 0
0 14 0
3 1 0
3 0 0
0 1 0
