width 20
height 20
@..@@.@@@@@@@..@@.@@
@@.@...@..@@.@.....@
@..@@.@.@..@...@@@@@
@.@.@.....@..@@.@.@@
......@@.@@@.@......
@.@.@...@@@...@.@.@.
...@..@@.@.@@....@@.
@.@.@@@@....@.@@@@..
....@@@.@@@....@..@.
.@@.@.......@.@.@...
@@..@.@.@.@.@...@@.@
..@.@@..@@@@@@.@@@@@
@....@@.@.@.@.@@@@.@
@.@@@.@........@@...
......@.@.@.@.@@.@.@
@@.@.@.@..@@........
@@@......@@@@.@.@@.@
@@@@@@.@.@.@@@.@@...
@@@@@@@....@@.....@.
@@@@@@@@.@...@.@@.@.
10
14 4 0
16 6 0
3 7 0
1 2 0
13 14 0
15 5 0
4 16 0
1 3 0
19 4 0
2 1 0

1 7 0
7 11 0
1 2 0
8 7 0
17 9 0
1 6 0
18 10 0
15 1 0
12 15 0
7 9 0
