width 20
height 20
@.@@@@@@.@.@.....@@@
..@@@@@....@.@@.@.@@
@..@@@.@.@..@.......
@.@.....@.@.@.@.@@.@
...@.@@@....@@....@@
@.@...@.@.@...@.@@..
....@.@..@@.@......@
@@.@...@...@@@.@.@@@
@@..@.@.@.@.@@@..@@@
@@.@...........@..@@
@.@.@.@.@@.@.@.@@..@
.......@@@@@@...@.@.
@.@.@.@@@@@@@@.@..@.
@..@.@.@.@.@.@@.@...
..@...............@.
@...@.@@.@.@.@.@.@@.
..@..@..@.@...@@@..@
@..@@.@...@@.@.@.@..
@.@....@.@.........@
....@@....@@.@.@.@@@
10
14 14 0
13 9 0
17 9 0
13 3 0
4 7 0
13 6 0
1 6 0
5 14 0
8 1 0
7 3 0

14 15 0
9 7 0
1 10 0
5 9 0
1 3 0
12 13 0
8 17 0
14 12 0
10 4 0
11 18 0
