width 20
height 20
@@@@..@@@@....@....@
.@@..@.@@.@@.@@.@@.@
..@@...........@.@.@
.@.@@.@.@.@@@@...@.@
.......@.@.@.@.@....
.@.@@.@........@@@@@
.@@@@@.@.@.@@.@.@@@@
....@.....@........@
.@@@.@.@@@@@.@.@.@..
..@.....@@@@.@@..@.@
@@..@@.@.@.....@@@.@
..@.@.@...@@.@....@@
.@@.....@...@..@.@.@
..@.@.@@..@.@.@..@..
.@@..@.@.@.@@@.@...@
.@@.@......@.@...@..
..@..@.@.@....@@.@.@
.@.@@@@@@@.@@@...@.@
.......@...@@.@.@...
.@.@.@...@.@.....@.@
10
7 12 0
7 15 0
16 19 0
12 5 0
12 1 0
4 14 0
4 4 0
8 6 0
6 4 0
10 5 0

19 13 0
16 3 0
8 16 0
11 16 0
6 19 0
5 0 0
0 14 0
0 16 0
14 5 0
2 7 0
