width 20
height 20
@@@..@@@@..@.@.@.@.@
@@@@..@@@@.@.......@
.@@@@..@@....@.@.@@@
..@.@.@.@@.@@@@...@@
.@......@.@@.@.@.@.@
..@.@.@.............
@...@.@@.@.@.@.@.@.@
..@..@@@..@@@..@@...
.@@@@.@.@.@@@@@..@.@
..@......@.@@.@@.@..
.@@@.@.@...........@
..@@..@..@@.@.@.@.@@
.@...@@@.@@@@@@..@@@
@.@.@.@.@.@.@@@@.@@@
@.@..........@@@@.@@
@...@.@.@@.@..@@@..@
@.@@.@...@@.@..@@.@@
.@@...@@@.....@@..@@
....@...@.@.@.@.@...
.@.@..@....@@.....@@
10
9 5 0
6 18 0
7 16 0
9 7 0
6 4 0
10 6 0
6 14 0
11 10 0
12 14 0
2 18 0

4 19 0
10 3 0
9 14 0
7 16 0
16 6 0
3 3 0
3 14 0
1 13 0
2 18 0
8 10 0
