width 20
height 20
@@@@@@@@@@@@@@@@@@@@
@@@@@@@@@@@@@@@@@@@@
@@@@@@@@@@@@@@@@@@@@
@@@@@@@@@@@@@@@@@@@@
@@@@@@@@@@@@@@@@@@@@
@@@@@@@@@@@@@@@@@@@@
@@@@@@@@@@@@@@@@@@@@
@@@@@@@@@@@@@@@@@@@@
@@@@@@@@@@@@@@@@@@@@
@@@@@@@@@@@@@@@@@@@@
@@@@@@@@@@@@@@@@@@@@
@@@@@@@@.@.@@@@@.@@@
@.@@@@@.....@@@...@@
...@@@@.@@.@.@.@.@@@
.@..@@@@.........@@@
..@.@@@.@.@.@.@@..@@
@..@@@..@@@@@@...@@@
..@.@.@.@.@.@@@@.@@@
@.@................@
....@.@.@.@.@.@.@.@@
10
0 19 0
16 16 0
0 15 0
3 15 0
9 18 0
10 12 0
13 19 0
11 15 0
14 14 0
1 19 0

14 16 0
1 18 0
13 15 0
9 18 0
7 18 0
12 18 0
10 11 0
7 16 0
9 19 0
15 18 0
