width 20
height 20
........@.@@@@.....@
@.@.@.@....@@@@@.@@.
@@@@.@..@.@@@@....@.
..@...@..@@@@@@.@...
.@.@.@@@.@@@@@@@.@.@
.....@.@.@@...@@....
@@.@.......@@.@@.@@@
@@@@.@.@@@.@........
@@@@@@@@.....@.@.@@.
@@@@@@@@@.@@..@@@...
@@@@@@@@@@...@@@@@.@
@@@@@@@@@@@.@@@@@@..
@@@@@@@@@@@@@@@@@@.@
@@@@@@@@@@@@@@@@@@@@
@@@@@@@@@@@@@@@@@@@@
@@@@@@@@@@@@@@@@@@@@
@@@@@@@@@@@@@@@@@@@@
@@@@@@@@@@@@@@@@@@@@
@@@@@@@@@@@@@@@@@@@@
@@@@@@@@@@@@@@@@@@@@
10
19 3 0
2 6 0
17 0 0
2 0 0
17 7 0
5 6 0
16 6 0
12 8 0
10 8 0
1 1 0

8 5 0
12 7 0
15 0 0
17 5 0
1 1 0
12 9 0
2 0 0
16 4 0
16 1 0
6 5 0
