width 20
height 20
@@.@.@.@@....@@@@..@
@.......@.@.@.@.@@..
.@.@@@.@@@.........@
.....@.@@..@.@.@.@..
@@.@@...@@..@@@@.@.@
....@.@@.@@.@@..@...
@.@@.@.@..@@@@.@.@.@
..@......@..@.......
@...@.@@..@...@.@@.@
@@.@@@...@@@@..@@...
@@.@.@@.@.@.@.@@@@.@
@.@..@........@@@@..
@.@.@.@@@@.@@..@@@.@
..@.@..@@@@...@.@.@@
@.@...@.@@..@.......
@...@......@.@@.@.@.
..@.@@.@.@.....@..@.
@@@@...@@.@@.@@@@.@.
@@@@@@..@.@@...@@..@
@@@@@@@.....@.@...@@
10
4 17 0
11 7 0
14 5 0
15 13 0
0 2 0
9 0 0
4 14 0
9 15 0
13 13 0
13 11 0

12 11 0
4 10 0
2 3 0
10 0 0
1 1 0
3 11 0
15 19 0
11 1 0
4 1 0
5 5 0
