width 20
height 20
@@@@@.........@.@@@@
@@@@@.@@.@.@.@@...@@
@.@@.@.@@...@@..@@@@
...@.@.@@@@.@.@.@@@@
.@...............@@@
..@@.@.@.@.@.@.@.@..
.@..@@@.@@..@@.@..@.
.@.@.@@..@@@..@.@...
...@.@.@..@.@.@...@@
.@.......@......@@.@
@@@@@.@.@@@.@@.@....
@@@@...@@@...@..@@.@
@@@.@@.@@.@.@@.@@...
@......@.....@...@.@
@@@.@@.@@.@@.@.@....
......@.@...@...@.@.
@.@.@.@...@..@.@@@@@
...@.@..@@.@@.@@.@@.
@.@....@.@.......@..
@@@@.@.....@.@.@...@
10
7 15 0
1 16 0
16 17 0
4 15 0
19 12 0
13 0 0
1 15 0
6 4 0
8 19 0
11 8 0

11 2 0
11 9 0
10 5 0
0 17 0
5 11 0
12 19 0
19 7 0
4 9 0
14 14 0
11 4 0
