width 20
height 20
@@@@@@@@@@@@@@@@@@@@
@@@@@@@@@@@@@@@@@@@@
@@@@@@@@@@@@@@@@@@@@
@@@@@@@@@@@@@@@@@@@@
@@@@.@.@@@@@@@@@@@@@
@.@....@@@@@@@@@@@@@
@..@.@..@@@@@@@@@@@@
..@@.@.@.@..@@@@@@@@
@.@.@.....@.@@@@@@@@
....@@@@@....@@@@@@@
.@.@.@....@.@.@@.@@@
@......@.@.@..@...@@
..@.@@..@...@.@@.@@@
@.@..@@..@@......@@@
@..@...@..@.@.@.@.@@
..@..@@.@.@@@@.....@
@.@@.@......@@@.@.@@
...@..@.@.@..@@@...@
@@@..@@@..@@@.@.@.@.
@@@.@@@@@...........
10
5 14 0
16 12 0
17 14 0
6 14 0
4 6 0
12 11 0
1 9 0
9 19 0
18 19 0
6 10 0

11 7 0
11 19 0
4 16 0
9 19 0
3 5 0
10 19 0
5 11 0
0 15 0
12 11 0
12 13 0
