width 20
height 20
.@.@..@.@@@.@@@.@@@@
...@@....@..@@@.@@@@
.@.@@.@.@.@..@@..@@@
..@..@......@.@.@.@@
.@@@.@.@.@.@.......@
..@..@@...@@@.@@@.@@
@..@.@.@.@@@@@.@...@
..@.......@@@...@.@.
@...@@.@.@....@.....
.@@.@.@@@..@@.@.@.@.
........@.@...@@..@.
.@@.@.@.@.@@@@@@.@@.
...@@@@@@.@.@.@@@...
@.@.@.@.@......@@@@.
..........@.@.@.@@@@
@.@.@.@.@..@........
.@.@.@...@@..@@.@.@@
.......@...@.@@@..@@
@@.@.@.@.@.@@.@.@...
@@@@..@@.@.@......@.
10
17 10 0
15 0 0
15 7 0
6 4 0
3 5 0
18 4 0
13 15 0
18 8 0
4 10 0
16 4 0

0 12 0
4 10 0
11 13 0
16 8 0
2 10 0
9 9 0
2 14 0
15 18 0
5 14 0
10 9 0
