width 20
height 20
.@......@@@@@@@@@@@@
..@.@.@.@.@@@@@@@@@@
.@..@..@..@@.@@@.@@@
.@@.@.@.@..@..@...@@
...@......@@@..@.@.@
.@@.@@@.@@.@.@......
...............@.@.@
.@@.@@.@.@.@@.@.@@..
..@@@@@.@@..@@...@.@
.@.@@.@....@@@@.@...
....@..@@.@@@@@.@@.@
.@.@.@.@.@.@........
@...........@@.@.@.@
..@.@@.@.@.@....@@@.
@..@@.@.@@@@.@.@.@..
@@@......@@..@.....@
@@.@@@.@@.@.@..@@.@.
@............@@.....
@@@.@.@.@.@.@.@@.@.@
@@...@@..@@.....@@..
10
13 6 0
13 13 0
6 6 0
16 2 0
12 13 0
9 18 0
3 2 0
2 14 0
19 9 0
5 12 0

14 15 0
3 3 0
3 13 0
13 3 0
11 16 0
8 6 0
5 2 0
2 6 0
5 1 0
10 3 0
