width 20
height 20
@@@............@....
@@.@.@.@.@.@@.@.@.@.
@.....@@..@.@....@@.
..@@.@...@@...@.@@..
@..@@..@...@.@.@.@@.
..@@.@..@@@.........
@.@....@@@@@.@.@@@.@
@@@@.@..@@.@..@..@.@
@@@.@@.@@....@@.@.@@
@........@@@.@.....@
..@@.@.@@...@..@@@..
.@..@..@.@.@.@@.@.@.
@..@@@.....@.@@...@.
..@@@..@.@......@...
.@.@.@@.@@@@.@.@..@.
........@@@@@.@..@..
.@.@@.@..@@@@...@@@.
..@..@.@@..@.@.@.@.@
.@.@...@.@.@.......@
.....@.......@.@.@..
10
5 11 0
0 19 0
11 13 0
19 0 0
16 9 0
17 1 0
2 9 0
3 15 0
1 13 0
11 19 0

11 19 0
4 9 0
14 2 0
0 15 0
7 5 0
5 6 0
8 16 0
18 0 0
1 19 0
0 10 0
