width 20
height 20
@@@@@@@@@.@@@@@@@..@
@@@@@@@@....@@@@@.@@
@@@@@@@.@.@..@@@...@
@@@@@@.....@@@@..@.@
@@@@@.@.@.@@@@@.@...
@@@.@....@@@@@.@.@.@
@@..@.@.@@@@@......@
@@.@...@.@@@.@.@.@..
....@@....@....@@@.@
@@.@.@.@.@@.@.@@@...
......@...@..@@@@@.@
@.@.@...@...@@@@@...
...@@@@@@.@@@@@@@@@@
@.@.@.@@@.@@@@@@@@@@
.........@@@@@@@@@@@
@.@.@@@.@.@@@@@@@@@@
@@@...@....@@@@@@@@@
...@.@@@.@..@@@@@@@@
.@....@.@.@...@@@@@@
@..@.@......@.@@@@@@
10
7 14 0
9 10 0
2 6 0
0 17 0
4 17 0
16 6 0
3 18 0
1 12 0
8 19 0
7 16 0

2 10 0
8 17 0
9 11 0
5 10 0
18 5 0
2 9 0
5 6 0
17 2 0
0 8 0
6 11 0
