width 20
height 20
.....@@......@@.....
.@.@.@..@.@@.@.@@@.@
@@@...@@.@..........
@@@@.@...@@@.@.@.@.@
@@@@...@..@@@@@@@...
@@@..@@@.@.@.@.@@@.@
@..@@...........@...
.@.@.@@.@.@@.@.@@@.@
.........@@.@..@@...
.@@.@.@.@@@.@@.@.@.@
..@@...@@@@.@.@.....
.@..@.@..@....@@.@.@
...@.@..@.@@@.....@.
.@....@.......@.@@@.
@.@@.@@@@.@.@..@@@..
......@.@..@.@@@@.@.
@.@.@.....@...@@....
@@@@@@.@.@.@@.@.@.@.
@@@@@@@...........@.
@@@@@@@@.@@.@@.@.@@@
10
11 6 0
5 11 0
7 11 0
14 6 0
4 15 0
10 13 0
4 5 0
4 4 0
12 1 0
3 8 0

4 3 0
6 8 0
1 14 0
18 9 0
14 2 0
9 0 0
3 13 0
1 8 0
18 10 0
4 2 0
