width 20
height 20
.@.@@@@@......@@@@@@
....@@@@@.@.@..@@@@@
@.@.@@@@...@@.@@@@.@
...@.@@@.@..@..@....
@.@..@@.@@@@..@.@.@@
...@.@...@.@.@......
.@....@@.......@.@@@
@..@@....@.@@.@.@.@.
@@.@.@@@..@@.@@.....
.......@.@......@.@.
.@.@@@..@.@.@@.@@@..
.@@....@...@@@@.@.@.
@..@.@...@@@@@@.....
@@..@..@..@@@@.@.@.@
.@@.@@..@@@@@..@@...
......@.@.@@.@.@.@.@
.@@@.@..............
..@@@@@.@.@.@.@@.@.@
.@.@.@.@...@...@..@@
.........@@@@.@..@@@
10
2 5 0
9 0 0
2 3 0
13 9 0
7 19 0
19 12 0
15 19 0
7 15 0
13 6 0
18 2 0

17 8 0
6 16 0
7 4 0
5 11 0
2 1 0
4 5 0
7 16 0
12 5 0
15 11 0
11 6 0
