width 20
height 20
@@.@@@..@.........@.
@.....@.@.@@.@.@.@..
@@.@@......@..@....@
@@@...@.@@@@@.@.@.@@
.@.@.@.@.@.@.@.@.@@@
...................@
@.@.@.@@@.@.@.@.@.@.
.@.@.....@@@@@..@...
....@.@@@@@.@.@@.@.@
.@@.@.@@@@.......@..
.@.@.@.@@.@.@@@@...@
..............@@.@@.
.@@@.@.@.@@@.@@..@..
.@.@..@.@.@.@.@.@@@.
.@...@.........@.@..
@@@.@.@.@.@.@.@...@.
@@......@..@...@@.@.
@.@@.@@@.@@..@@.....
...........@....@.@.
.@.@.@@.@@.@@.@..@..
6
18 9 0
10 19 0
6 5 0
16 11 0
0 12 0
8 18 0

10 9 0
1 8 0
6 16 0
1 17 0
14 1 0
10 5 0
