width 20
height 20
.@.@@@@@@@@....@..@.
....@@.@@@@@@.@..@..
@.@@....@.@.@.@@.@@.
.....@.@..@.........
.@@.@...@.@.@.@@.@.@
.@.@.@.@..@@.@..@...
@.......@..@...@@@@.
@.@.@@.@..@.@.@.@.@.
...@.....@..........
.@.@.@.@.@.@@@.@@.@.
.@..@@..@.....@@.@@@
@.@.@.@..@@@.@....@@
@......@@.....@@.@.@
@.@.@.@@.@.@.@@....@
...@..@....@@..@.@..
@.@.@@.@.@..@@....@.
.......@@.@.@.@.@.@.
.@@.@@........@@.@..
...@@.@.@.@.@....@.@
.@.....@@@...@.@....
6
15 13 0
14 14 0
8 3 0
10 15 0
12 5 0
2 0 0

15 13 0
14 0 0
13 6 0
11 17 0
1 15 0
2 1 0
