width 20
height 20
..@..@@@...@.@..@.@@
.@.@.@@@@@.@...@...@
......@@.....@@..@@@
.@@.@...@@.@...@..@@
.@.@@.@..@@@.@@..@@@
...@.@..@@@@...@..@@
@@...@@@.@@..@...@.@
@@@@..@...@@.@@.@...
@@@@@..@.@.@@...@@.@
@@@@.@.....@.@@.....
@@@..@@.@@......@@.@
@..@.@@@...@@.@.@.@@
@@.....@@@..@@......
@@@.@.@@.@.@..@.@.@.
..@@........@.@@.@..
.@@@@.@.@.@@.......@
..@@@@@@.@@.@.@@.@..
.@.@@..........@.@@.
......@@@@.@.@.@...@
@.@.@.....@@@@@..@..
6
10 2 0
10 10 0
18 10 0
0 18 0
14 18 0
5 4 0

12 3 0
0 17 0
16 4 0
13 10 0
4 9 0
3 19 0
