width 20
height 20
@.@.@...@...@..@..@@
.....@.@.@.@.@.@.@.@
.@@@................
@@@..@.@@.@.@@.@@.@.
@@..@.@..@.@.....@@.
@.@...@@.....@.@...@
..@.@...@@.@..@@@@..
@..@..@@@@@@@@.@.@.@
@.@.@.@.@@.@.@...@@@
...............@...@
.@@.@.@.@.@.@.@@.@@@
...@@@@@@@@@.@....@@
.@@@@.@...@....@.@@@
.@.@@...@.@@.@@.@@@@
......@..@......@@@@
.@.@@..@.@@.@.@..@.@
@@@...@.@.@@@@..@@..
....@.......@@@.@.@.
.@@..@.@.@.@.@......
@@@.@@.@@@....@.@.@.
6
9 3 0
19 16 0
8 14 0
18 7 0
15 2 0
1 9 0

1 8 0
13 10 0
0 6 0
14 14 0
1 5 0
4 9 0
