width 20
height 20
@@@.@@@..@@.@.@.@.@@
@....@..@..........@
@@.@...@@@.@.@@.@.@.
@@@@@@..@...@@@.@...
@..@.@.@.@.@.@.@.@.@
@.@..@....@.........
...@...@.@.@.@@@.@@.
@.@..@@@.......@.@..
...@...@.@.@@.@...@.
@.@.@.@@@.@..@@@.@@.
..........@.@.@.@@.@
@.@@@.@.@...........
@....@@@@.@.@.@.@.@.
@.@.@.@@@..@@@...@@@
@@.....@..@@@@@.@...
@@@@.@@@@@.@@@....@.
@@...@.@.@..@@@.@@..
@@.@.......@.@...@@.
@@@..@.@.@@...@@..@.
@@@@.@@...@.@....@..
6
11 19 0
16 8 0
19 18 0
14 4 0
16 4 0
17 8 0

15 3 0
2 4 0
19 19 0
11 9 0
8 17 0
11 19 0
