width 20
height 20
@.@@@@....@@@@....@.
....@@@.@.@.@.@.@@..
@.@..@...@.......@@.
.@..@..@.@@.@.@.@...
..@..@.@...@.@@.@@.@
.@.@..@@.@@...@.....
.@...@@..@..@.@.@@.@
...@....@.@@...@....
.@@.@.@......@...@@.
@....@..@.@@.@@@...@
@@@.@@@..@..@.@@@.@@
@@....@.@.@.@..@@@@@
@@@.@@........@@@@@@
@@..@.@@.@@.@@@@@@@@
@.@.....@.@.@.@@@@@.
@...@.@...@.....@@..
..@.@.@.@..@.@@..@@.
@.@@.@...@.@..@.@.@.
......@@@.@.@@@.....
@.@.@...........@.@.
6
2 11 0
11 5 0
7 1 0
11 8 0
7 12 0
19 16 0

2 13 0
16 16 0
8 4 0
0 5 0
3 15 0
6 12 0
