width 20
height 20
@@..@.@..@@@@......@
@@.@@.@.@@@@@@@.@@..
@@......@@@@@@.@@.@.
@@@.@.@.@.@@@.......
@@.@@@.....@..@.@.@.
@..@@.@@@.@.@.@.@.@.
.@.@...........@.@.@
.....@.@@.@.@@......
.@@.@@@@.@...@.@@.@.
.@...@.....@@.@.@.@.
..@.@.@.@.@.@....@..
@.@@..@@@@....@@.@@.
..@.@.@.@@@.@.@.@.@.
@...@....@@@........
..@...@.@.@@@.@.@.@.
@@@@.@.....@..@..@@@
...@@.@.@.@.@.@@@...
@.@.@.@@@@........@.
....@.@.@.@@@.@@.@..
@.@...........@...@.
6
16 18 0
16 17 0
13 5 0
9 19 0
13 14 0
7 3 0

1 16 0
13 4 0
3 3 0
10 9 0
14 3 0
16 19 0
