width 20
height 20
@@@@@@@@@@@@@@@@@@@@
@@@@@@@@@@@@@@@@@@@@
@@@@@@@@@@@@@@@@@@@@
@@@@@@@@@@@@@@@@@@@@
@@@@@@@@@@@@@@@@@@@@
@@@@@@@@@@@@@@@@@@@@
@@@@@@@@@@@.@.@.@@@@
@@@@@@@@@@.......@@@
@@@@@@@@@@.@.@.@@.@@
@@@@@@@@@..@@......@
@@@@@@@@@@..@@.@@.@@
@@@@@@@@@@@...@@....
@@@@@@@.@@..@@@.@.@.
@@@@@@@...@.@...@@..
@@@@@@@.@@....@@@.@.
@@@@@@...@@.@......@
@@@.@.@.@@.@.@.@.@.@
@@..............@@..
@@@@@.@.@.@.@@.@...@
@@@@@@...@....@@@@..
6
8 19 0
12 8 0
13 15 0
14 16 0
15 6 0
16 16 0

18 18 0
14 18 0
15 15 0
19 12 0
6 17 0
18 13 0
