width 20
height 20
@.@......@.@@@@@@@@.
....@.@@...@@@@@@@@.
@.@.@...@.@@@@@@@@..
@@@@@@@@...@@@@.@.@.
@.@@@.@.@@........@.
..@@.......@@.@.@...
@...@@.@.@@..@.@@.@.
..@.....@..@.@.@.@..
.@@@.@.@@@.@.......@
@@@@@...@....@.@@.@@
@@@@.@.@@@.@..@@@@@@
........@@..@@@@@...
.@@.@@.@@@.@@@@@@@@.
@@@...@.@@..@...@.@.
@.@.@.....@..@@.@...
...@@.@.@.@@.....@@.
@@.@...@@@.@.@.@.@..
.....@@......@@....@
.@.@...@.@@.@@@.@@@@
..@@@.@@.@...@@@@@@@
6
13 4 0
7 5 0
10 13 0
11 9 0
2 15 0
17 13 0

8 5 0
1 6 0
13 13 0
11 13 0
8 6 0
11 19 0
