width 20
height 20
@..@...@.....@.@@@@@
..@..@...@.@....@@@@
@...@.@.@@@..@.@@.@.
@@.@..@@....@.......
@....@.@.@.@@@.@.@.@
..@@...@@..@@.@@@...
@.@..@.@@@..@...@@.@
@@@@@..@@@@..@.@.@..
@.@@.@...@@@.@.....@
@......@...@@..@@@@@
..@.@@@.@@@@@.@.@@.@
@..@@@.....@........
..@.@.@.@@@.@@.@.@.@
@.@......@..@@@@@...
....@.@@.@.@.@...@@.
@.@.@@..@......@....
@@@@...@.@.@@@..@.@.
@@@@.@........@.@@@@
@@@@@@.@@@.@@@....@@
@@@@@@@@@@..@@@.@.@@
6
16 18 0
8 1 0
1 1 0
19 3 0
3 13 0
6 7 0

8 16 0
14 12 0
13 6 0
10 13 0
11 0 0
7 15 0
