width 20
height 20
@@@.....@..@@@@@@@@@
@.@.@.@..@.@@@@@@@@@
..@@@@.@....@@@@@@@@
@...@....@.@@@@.@@@@
..@@@.@@.@....@.@@@@
@.@.@.@.@..@.@...@@@
........@@.@@.@.@@@@
@.@.@.@..@......@@@@
...@..@.@.@@.@@...@@
@.@@@@.....@.@@.@.@@
@.@@@@@.@.@.@@..@@..
..@@..@@......@@@.@.
@.@..@@.@@@.@@......
...@....@...@..@@.@.
@.@@@.@..@@..@.@...@
@....@@@..@.@.@.@.@.
.@.@@.@@@...........
.......@@.@.@.@.@@.@
.@.@.@...@@@@@.@.@.@
..@@@..@@@@@@@.....@
6
16 16 0
15 3 0
1 6 0
5 0 0
9 15 0
16 8 0

16 16 0
0 19 0
5 14 0
10 7 0
1 6 0
1 1 0
