width 20
height 20
@@@@@@@....@.@...@.@
@@@@@@@@.@@....@....
@@@@@@@...@@.@..@@@@
@@.@.@.@.@@...@@@@@@
@..........@.@.@@@@@
@@.@@.@@.@@.....@@@@
@..@@@@@.@@@.@.@.@@@
@.@.@.@.@.@.@.....@@
.............@.@.@.@
@.@.@.@.@.@@..@..@.@
@@@..@...@...@..@...
@..@@@@.@@@.@@@..@.@
..@.@.@@@@...@@.@...
@.......@@.@......@.
..@@.@.@@@@..@.@.@@.
@.@.@.@.@.@@..@@@...
............@.@@@@@.
.@.@.@.@.@.@.@.@@.@.
@...@@.@@@..........
@@.@@@...@@.@@@.@.@.
6
10 4 0
0 16 0
5 12 0
11 7 0
14 13 0
17 7 0

7 2 0
10 18 0
17 1 0
19 10 0
11 12 0
15 7 0
