width 20
height 20
......@..@..@.@.@@..
.@.@@.@.@.@.......@.
@..@........@.@.@@..
@@..@@.@@.@..@@...@.
@@.@...@.@.@@@@.@...
..@@@@.@.@.@.@.@..@.
.@.@.@.........@.@@@
.......@@.@.@@.@.@@@
@.@.@.@..@.@....@.@@
..@..@@@....@.@.....
@@.@@.@..@.@@@..@.@@
@.....@.@.@@@.@..@@@
..@.@...........@.@@
@.@..@@.@@.@.@.@...@
.@..@@..@...@@@..@..
...@@@@..@.@.@.@@..@
.@.@....@......@.@.@
..@..@@.@@@@.@...@.@
@.@@.@@@@....@.@....
....@@@@@.@.@..@.@.@
6
1 7 0
15 0 0
9 16 0
3 7 0
16 16 0
15 1 0

8 9 0
19 9 0
6 6 0
17 1 0
5 1 0
16 5 0
