width 20
height 20
@..@..@@@@@@@@@@@@@@
@.@..@@@@@@@@@@@@@@@
@...@@@@@@@@@@@@@@@@
@@@.@@@@@@@@@@@@@@@@
@@@..@@@@@@@@@@@@@@@
@@..@@@@@@@@@@@@@@..
..@..@@@@@@@@@@@@.@.
@...@@@@@@@@@@@@....
@.@.@@@@@@@@@@@.@.@@
.@...@@@@@@@@@.....@
..@.@.@@@@@@@@@.@.@.
.@@.@..@@@@@@@.@....
.....@..@@@@@@..@.@.
@.@@...@@@@@...@@@..
.@.@.@@.@..@.@@.@.@.
.........@.@.@......
.@@.@.@@.@.....@.@.@
...@@@@....@.@.@..@@
.@.@....@.@...@..@@@
@..@@.@..@@@.@@@.@@@
6
5 19 0
19 13 0
12 18 0
9 14 0
17 11 0
6 18 0

4 4 0
2 5 0
4 1 0
4 15 0
12 16 0
16 17 0
