width 20
height 20
@@....@@@@@@..@@@@@.
@..@.@@@@@@@@...@@..
..@.@.@@@@@@@@.@@.@.
@.@.@..@@@@@.@..@...
......@.@@@....@@.@.
@.@.@....@..@.@@.@..
...@@@@.@.@..@@...@.
@.@@@@......@@..@...
@@@@@@@@.@@..@.@..@@
@@@@@@@.@.@.@...@...
@@..@........@@.@.@.
@.@...@.@@.@@@.@.@..
....@@@@@@.@.......@
.@@.@.@.@.@@@.@.@.@@
@@.............@..@@
@@@.@.@.@.@.@.@@@..@
@@...@.@.@.@.@.@.@..
@.@.@.............@.
......@.@.@.@@.@.@@.
.@@.@@@@@@..@..@@@@@
6
17 6 0
0 18 0
2 4 0
1 17 0
16 6 0
3 2 0

2 0 0
15 9 0
12 12 0
15 13 0
5 14 0
3 0 0
