width 20
height 20
.@@..@@@....@@@@@@..
....@.@.@@.@@@@@@@.@
@.@.........@@@@@..@
...@.@.@.@.@...@.@..
@.@.@.@@@...@@.....@
@......@.@.@...@.@..
..@.@.@@....@@..@..@
.@@@..@..@.@@..@@.@@
..@@@.@@.@@..@...@@@
.@@@@@@...@.@..@..@@
..@@@@.@.@..@@..@@@@
.@.@@@.@.@@....@@.@@
@...@.....@.@@....@@
.@.@.@.@@..@.@.@.@.@
........@.@@.@@.....
.@.@@@.@.@.@.@.@.@@.
.@@.@.@...........@@
........@.@.@.@.@...
.@.@.@@.@@@..@@@..@@
..@...@...@.@@@@@...
6
16 15 0
18 19 0
8 0 0
3 16 0
8 6 0
1 19 0

14 13 0
8 7 0
18 19 0
5 16 0
5 6 0
17 18 0
