width 20
height 20
@@@@@@@@@@...@@@@@@.
@@@@@@@@@@@.@@@@@@..
@@@@@@@@@@..@@@@@.@.
@@@@@@@@@.@..@@@....
.@@@.@..@...@.@.@.@.
..@..@@...@@.......@
.@.@.@.@@..@@.@.@@@.
..........@@@@..@.@.
@.@.@@@@@.@.@@@.....
@..@......@.@@@.@.@.
..@..@.@@.@......@..
@..@@....@..@@@.@..@
..@@@.@@@..@@@@@.@.@
@...@.@..@..@@@..@..
..@@....@..@.@.@...@
@...@.@...@..@...@..
@@@@.@.@.@@@.@.@.@.@
@@@@.....@@..@..@...
@@@@@.@@...@...@..@.
@@@@@@...@@@@.@@@.@.
3
15 15 0
17 2 0
16 15 0

13 19 0
8 17 0
0 5 0
