width 20
height 20
...............@.@.@
.@.@.@.@@.@.@.@....@
..@@@.@....@@@@.@@@.
.@@@@..@@.@.@.....@.
..@..@.@.....@.@@...
.@.@.@.@@.@@@.@@..@@
.........@@@..@.@...
.@.@.@@@..@.@...@.@@
@.@.@.@.@.....@....@
.........@.@.@.@.@..
.@@@@.@.@@@.@..@.@.@
..@...@..@....@...@@
.@.@@.@.@@@.@@.@@.@@
...@.@.@.@........@@
.@.........@@.@.@.@@
@@@.@.@.@@...@.@.@.@
@@...@.@...@........
@.@.@@...@@..@.@@.@@
@....@.@...@@@@...@@
..@.@...@@..@@@.@.@@
3
9 0 0
4 16 0
6 3 0

9 4 0
5 14 0
3 15 0
