width 20
height 20
@@@......@@@@.@.@...
@@..@@.@.........@.@
@.@..@@..@.@.@@.@...
....@@.@@@@..@....@.
@.@@...@.@@@.@@@.@@.
.....@@@..@.....@.@.
.@.@.@...@@@.@.@....
@@..@..@..@.@...@.@.
@.@@.@.@.@@.@@.@@.@.
......@@........@..@
@.@@.@.@@@.@.@.@@.@@
..@@@....@..@.@@@@@@
@...@.@.@@@......@@.
@.@....@@@..@.@@....
...@.@@.@.@..@@@.@.@
@.@@@@......@@..@...
@..@@@.@@.@.@@.@@@.@
..@@@@..@@.@...@....
.@.@.@.@....@.@..@.@
.........@@...@@..@@
3
1 11 0
18 17 0
9 14 0

6 18 0
16 19 0
8 15 0
