width 20
height 20
..@@@@@@@@@@@@.@@...
.@@@@@@@@@@@@..@..@@
..@@@@@@@@@@@@.@@..@
@..@.@@@@@.@.@.@.@..
.@.@..@..........@.@
...@.@@@.@@.@.@@....
.@.....@..@..@.@@.@.
.@@@@.@..@..@....@..
.@@@.@@@@.@...@.@.@.
..@........@@.@@...@
.@.@.@.@@.@.@.@.@.@.
......@@............
.@.@.@@@@@@@@.@.@.@.
.@.@@@@@@@..@@@@...@
.@.@.@@@@@.@.@@@.@@.
..@...@@@.....@.....
.@.@.@@...@@.@@.@.@.
......@@@@.@...@@@..
.@@.@@.@.@...@@.@.@.
@....@.....@........
3
0 5 0
3 18 0
6 18 0

11 5 0
0 9 0
8 16 0
