width 20
height 20
@@..@@@....@.....@.@
@..@.@.@@.@.@@@@....
..@@.@......@.@.@@.@
@......@.@@.........
..@.@.@....@.@.@@.@@
@.@..@..@.@@@.@@@@@@
...@@@.@@.@@..@@.@@@
.@..@.@.@@.@@.@..@@@
..@.............@.@.
@..@.@.@.@.@.@@.@...
@@..@@@.@.@.@.....@.
@@.@.@@.@.@.@@.@.@..
@............@.@@@.@
.@@.@.@.@@.@..@.@...
....@@..@@@..@...@.@
@.@...@..@@@..@.@@.@
..@@.@@@@@@@@.@..@..
@..@..@@.@.@.@.@.@.@
@.@..@.............@
@@@@..@@.@.@.@.@.@..
3
18 1 0
4 18 0
12 14 0

15 14 0
19 3 0
7 10 0
