width 20
height 20
@@@@@@@@@.@.@@@@.@@.
@@@@@@@.......@.....
@.@@@...@@@.@@.@.@@@
@.@@@@@.@...........
...@@.@@.@@@@.@@.@.@
.@.....@..@.@@...@@@
..@.@.@.@...@@@.@.@@
.@.@......@..@.....@
@@...@.@.@..@..@@@..
...@.@..@@@..@.@...@
@.@.@.@@.@..@.@.@.@.
.........@@.........
@.@@.@.@...@.@.@.@.@
.@@.@.@.@.@@@.@@@@..
........@..@@.@.@@.@
.@.@@.@...@......@..
..@...@.@..@@.@.@@.@
@.@@.@.@..@...@.....
....@....@..@..@.@.@
@.@.@.@@.@@..@.@@...
3
11 7 0
10 1 0
11 2 0

3 18 0
8 11 0
0 16 0
