width 20
height 20
@@@...............@@
@@.@.@.@@@@.@@.@@.@@
@@....@@...@@@@...@@
..@@.@..@@..@@.@@..@
@.@....@.@.@.@.@@@..
...@.@..........@..@
@@..@@.@.@.@.@@@@@@@
...@..@@@@@@...@@@@@
@.@.@........@..@@@@
....@@.@.@@.@@@@@@@@
.@@.@..@...@@@@@@@@@
.@...@.@@.@@@@@@@@@@
@@@.@....@.@.@@@@@@@
.@...@.@......@@@@@@
..@@.@@..@@.@..@@@..
.@.@.@@@@.@@..@.@.@.
......@@..@@@.......
@.@@.@.@.@.@.@.@.@.@
@@..............@...
@@@.@.@.@@.@@.@@@@.@
3
1 7 0
1 16 0
17 2 0

13 0 0
13 19 0
10 13 0
