width 20
height 20
@@@@@@@.@@.@...@@@@@
@@@@@@..@....@@@@@@@
@@@@@@@..@.@.@@@@@@@
@@@@@@.@..@@..@@@@@@
@@@@.@...@@@.@.@@@@@
@@@....@.@@....@@@@@
@@.@.@@.@@@@.@..@.@@
@...........@@.@..@@
@@.@.@.@.@.@.@..@.@@
@.@@..@..@.....@@...
....@@.@@.@.@@@@..@.
@.@...........@.@.@@
...@@@.@.@.@.@@....@
@@..@...@.@.@.@.@@@.
@@@@..@.............
@@@@@@@@.@@@.@.@@.@.
.@.@@@@.@.@.@.@.@@@.
....@@..@.......@.@.
.@.@@.@.@.@.@.@.....
@..........@@@..@.@.
3
15 13 0
8 12 0
3 13 0

4 11 0
0 16 0
6 19 0
