width 20
height 20
..@..@..@...........
@..@...@.@.@.@@@.@.@
..@@@@.....@....@@@@
@..@.@.@.@.@.@@.@@@@
@.@...@...@.@.@@@@@@
....@.@@.@......@.@.
@@.@.@.....@@.@@@...
@......@.@@@..@..@@.
@@.@.@..@@@..@@.@.@.
@@@..@.@.@@@.@......
@@.@@@@...@...@.@@.@
@....@.@.@@.@.....@@
..@@.......@@.@@.@.@
.@...@.@.@...@@....@
@@@.@...@..@.@@@.@.@
.@...@.@@@..@.....@@
.@.@@.@.@@.@.@.@.@@@
......@.@.@@.@..@@@@
@.@.@..........@@@@@
..@.@.@@@@.@.@.@@@@@
3
16 13 0
11 8 0
10 5 0

15 10 0
2 17 0
10 16 0
