width 20
height 20
@@@@@@..@@.@@@..@@.@
@@@@@@.@....@..@.@..
@@.@@....@@..@.....@
@.....@@.@.@@@@.@.@@
@@@.@.@.....@@.@...@
.....@@@.@@.....@.@.
@.@.@.@@@...@@@.@.@.
@@.....@@@.@.@@...@.
@.@@.@@@@@.@...@.@..
...@@@@@@@...@.@@.@.
@@..@@@@@.@.@.......
@@.@@@@@..@@@@.@@.@.
@...@@@@@.@@@.@.@@@.
.@.@.@.@...@........
........@.@.@.@@.@.@
.@.@.@@.........@...
@.@@@.@.@.@.@.@..@.@
.......@@@@.@..@@@..
@.@.@.@.@....@@....@
@.@@@.....@.@@@@.@..
3
16 16 0
11 16 0
16 13 0

11 18 0
7 16 0
11 5 0
