width 20
height 20
@@....@.@@@@@@@@@.@.
@..@.@...@@@@@@@....
@@..@.@@.@@@@@.@@@.@
.@.@......@.@.......
.....@.@@....@@@@.@.
.@@.@.@.@.@.@@.@...@
.@.@....@@@@@@...@..
...@@.@...@.@.@@@.@.
@@..@..@.@.....@@...
...@..@.@..@@@.@@.@.
@.@.@...@.@.@.@.@.@.
......@.@.@.....@..@
.@.@.@@.@...@.@...@.
.@.@.@...@.@@@@.@...
@.@.@.@.@@@.@@.@.@@.
.........@..........
.@.@.@.@@.@.@.@@.@.@
..@.@.@......@..@...
.@@.....@@.@...@@@@.
....@.@.@@..@.@@....
3
17 17 0
6 6 0
14 18 0

7 13 0
5 5 0
2 4 0
