width 20
height 20
.@..@..@.@@@.@@.@@..
.@.@..@...@.....@.@.
.....@.@.@@.@.@.....
.@.@......@@@@..@.@.
@..@.@.@@@@@@@@.@@..
..@.@.....@@.@....@.
@@....@@.@....@.@..@
@@@.@..@@.@.@..@..@@
@@...@@.@..@@.@@@..@
@.@.@@....@.@.@...@@
......@.@.......@...
.@.@.@...@@.@.@..@.@
..@@@..@...@.@.@@@@@
.@.@.@@..@.@.@.@.@.@
........@...........
.@@.@.@..@.@.@.@@.@@
@@@@@@..@@@...@@....
@@@@@.@.@@.@.@@.@.@.
@@@@....@....@.....@
@@@@@.@..@.@..@.@.@@
3
7 3 0
6 7 0
15 5 0

15 1 0
17 3 0
9 8 0
