width 20
height 20
@.@@...@@.@@@@@@..@@
....@.@.....@@@@@.@@
.@.@...@@.@.@.@...@@
@...@@.....@@.@.@..@
.@.@..@.@@..@.@@..@@
.@...@@@...@@...@..@
...@.@@@@.@@..@@..@@
@.@..@......@.@.@...
..@@..@.@.@.......@@
.@.@@.@@.@..@.@.@...
....@@...@.@@@@@..@@
.@.@@.@.@.@.@.@.@...
@..@..............@.
@.@@@.@@@.@.@@.@.@..
...@....@@.@@.@@@.@.
.@@@@.@............@
.@.@.@@.@.@.@.@.@@..
.......@..@.@.@@...@
@.@.@.@.@..@@..@@@..
@@..@.....@@@@....@.
3
5 15 0
6 7 0
13 17 0

5 8 0
9 0 0
4 14 0
