width 20
height 20
@...@@@....@.@.@@.@.
.@.@.@.@.@..........
.@......@@@.@@.@.@.@
...@@.@..@@@.@@...@@
@.@..@.@.......@@.@@
@...@....@.@.@..@..@
..@@.@.@@.@@@..@@.@.
@.@.......@@@@....@.
@.@@.@@.@...@..@@...
.@.@@.@@.@.@@@.@..@.
....@.......@.@.@@.@
.@.@..@@.@.@........
..@@@.@.@.@..@@.@@.@
@...........@.@@....
@@.@.@@.@@.@....@.@@
@...@@@@..@@@@@.....
.@.@.@.@@..@.@@@.@@.
..........@.....@...
.@.@.@.@.@.@.@@.@.@.
@...@...@....@.....@
3
9 19 0
4 16 0
18 12 0

6 16 0
1 0 0
12 18 0
