width 20
height 20
@.@.@.......@@.@.@@@
......@.@.@@@@.@.@.@
@.@.@.@.@@.@@@......
...@.@.@@....@.@.@.@
.@........@.@..@@..@
..@.@@.@@..@.@.@@@.@
@..@@@@...@.....@@@.
..@.@..@.@.@@@.@.@..
@....@......@.....@.
@@.@@..@.@.@@@.@.@@.
@@@@@@..@@@@@@@@..@.
@@..@@@..@@@@....@..
@@@.....@@.@.@.@...@
@@..@@@@@.......@.@.
@.@.@@.@.@.@.@.@@@..
.....@.....@@@.@@.@.
.@.@@@.@.@.@.@......
..@..@.@@.@..@.@@@.@
.@.@........@@@.....
.....@.@.@.@@@@@.@.@
3
10 7 0
10 5 0
19 8 0

0 17 0
14 13 0
6 8 0
