width 20
height 20
@@@@@@@@@@@@.@@.@...
@@@@@@@@@@@@......@@
..@@@@.@@@..@@.@@.@.
.@.@@@.@@.@.@@@.....
.............@.@.@@.
.@.@.@.@@@.@......@.
..@..@.@...@.@@@.@..
.@..@.@@@@@@@....@@@
..@...@@.@.@.@.@.@@@
.@@@.@..........@@@@
..@.@@@.@.@.@@.@@@@@
@.@..@@..@.@@.@@@@@@
.@@@....@......@.@@@
..@..@@@.@.@.@....@.
.@@@...@..@.@..@.@..
..@@.@.@.@@...@.@..@
@.@.@.......@....@..
....@@.@.@.@@.@@...@
.@@...@.@@@@.@...@@.
.@..@..........@....
3
17 3 0
12 15 0
16 13 0

14 1 0
13 16 0
6 2 0
