width 20
height 20
.@@.@..@.@@@.@@@....
......@...@......@.@
@.@.@...@@@@.@@.@.@.
...@..@@..@..@@@@.@.
.@@.@....@.@.@..@...
.....@.@......@...@@
@.@.@.@@@@.@@...@.@.
.@.....@...@@@.@....
..@.@.@@@.@...@@@.@.
@.@..@@@@@..@.@@..@.
@...@@@..@@@...@.@..
@@.@....@...@.@.@.@.
@@@@@.@..@@.........
@@@@.@@@....@.@@@.@@
@....@...@.@.@@@.@@@
@@.@.@.@.@........@.
@...@@@@@..@.@.@.@@.
.@.@.@.@.@.@@@@.....
.............@@@@.@.
.@.@.@@.@.@.@@@@@@..
3
17 2 0
17 11 0
9 3 0

14 7 0
0 7 0
19 17 0
