width 20
height 20
@.@..@@...@....@...@
...@.@@@.@.@.@@..@..
.@.............@.@.@
..@.@.@@.@.@.@@.@...
.@...@@@@@@@..@..@.@
@.@.@@@@.@.@.@.@....
....@.@..........@@@
@@.@....@@.@@.@.@.@.
@@@@@.@.@..@@@......
@..@.@@.@@..@@@.@.@.
..@..@..@@@.@@@@@@..
@.@@..@..@@@@@@....@
.....@@.@.@.@@.@@@..
@@@.@.@.@........@@@
@.....@...@.@.@.@..@
@@@.@...@..@@@....@@
@@@@..@..@@@@@@@@.@@
@@@@@..@.@.@@..@....
@@@@..@@......@.@.@@
@@@..@@@@.@.@@@....@
3
3 6 0
7 0 0
2 7 0

1 0 0
10 3 0
18 0 0
