width 20
height 20
...@@...@.@.@..@..@@
@.@.@.@.......@@.@@@
@.@.@@.@@.@.@.@@.@@@
.......@@@...@.....@
@.@@.@.@@@@.@.@@.@@@
...@.@@@@@........@@
@.@.@.@@@.@.@@.@@@..
..............@@...@
@.@@@@.@@@.@.@...@..
@@@@@@@.....@.@.@@.@
@@@@@@@@.@.@@..@.@..
@@@@@@@@..@@..@@...@
@@@@@@@..@@@@..@.@@.
@@@@@@@@..@...@.....
@@@@@@@..@.@@..@.@.@
@@@@@@@@...@.@....@@
@@@@@@@..@...@.@@@.@
@@@@@@@@.@.@........
@@@@@@@@@.@@.@@.@.@@
@@@@@@@@.....@..@@@@
3
4 3 0
9 1 0
12 13 0

3 7 0
13 14 0
9 1 0
