width 20
height 20
....@@@@............
......@.............
............@....@..
.............@....@.
...........@...@....
........@...........
..........@.@.....@.
........@.....@.....
...@....@...........
..@........@......@.
.......@.....@......
....................
....@...@.@........@
....@@@@............
...............@....
...@.@.@.@....@.....
..@.................
....................
..@.........@.......
@................@@@
5
3 5 0
6 16 0
11 12 1
19 0 1
17 12 2

5 16 0
9 13 0
11 7 1
19 3 1
0 2 2
