width 20
height 20
....................
@...................
....@.......@.....@@
..........@........@
....................
.@.....@............
.......@............
..@......@.@.@......
.@..................
.................@..
.@........@.@.......
......@..@.@........
............@....@..
....@......@........
.........@.......@..
....................
.......@..........@.
@.@.@........@......
@@@.................
@@@.....@..........@
5
5 12 0
1 1 0
7 3 1
8 5 1
14 11 2

14 1 0
1 7 0
13 18 1
17 19 1
11 5 2
