width 20
height 20
....................
.....@.@....@.......
@........@......@..@
@@...@......@..@....
.....@.@...........@
.@.................@
......@..@....@....@
...@....@......@....
.................@..
..@.......@....@....
.......@.........@..
..@.................
........@.....@@....
@.....@.............
...@................
.....@..............
.@.....@...@...@....
..........@..@.....@
.........@.@.......@
...................@
5
10 1 0
12 15 0
11 0 1
4 12 1
18 3 2

14 11 0
8 15 0
0 17 1
17 1 1
0 11 2
