width 20
height 20
....@..@.....@.....@
....................
...........@....@...
.......@.....@......
....................
..@...........@.....
....................
............@.......
.........@......@...
.............@......
....................
.@...............@..
.....@......@.......
..@........@......@.
....@...............
........@......@....
...........@......@.
...@.@..........@...
....................
.....@......@@@.....
5
17 2 0
3 11 0
6 2 1
7 19 1
8 13 2

19 1 0
18 2 0
12 9 1
19 2 1
10 18 2
