width 20
height 20
@@@..@@@.....@......
.............@......
......@.............
....@.@.@...........
...........@.....@..
.@............@.....
......@.............
............@.....@.
.@............@.....
........@.........@.
.........@.........@
@.....@...@...@.....
@...........@.......
@...@..@......@.....
.............@.@....
..@.@..@@@..........
.......@..@.....@...
..................@.
.........@..........
....@..............@
5
15 18 0
7 7 0
0 7 1
16 1 1
6 5 2

15 1 0
17 17 0
0 7 1
3 8 1
7 3 2
