width 20
height 20
...................@
...................@
.......@.@..........
....@......@..@.@...
..................@.
@.........@.......@@
............@......@
....@...........@...
.@.....@.@..........
....................
.............@.@....
...........@..@.....
.@..@...........@...
@....@..............
....................
@...@...............
.................@..
..............@.....
......@....@........
............@.......
5
14 18 0
5 0 0
6 11 1
16 10 1
15 15 2

6 1 0
11 10 0
18 18 1
2 2 1
1 0 2
