width 20
height 20
......@@...........@
......@@...@.@.....@
.....@........@..@..
....@...............
@...................
@@..@...............
@.........@.........
...............@....
.........@.......@..
..........@.@.......
.@..............@...
...@.@.............@
................@..@
..............@.....
...........@........
.@......@......@....
.........@..........
...............@....
@.........@.........
@@................@.
5
10 3 0
0 2 0
11 6 1
12 5 1
19 18 2

10 3 0
17 11 0
19 5 1
9 14 1
16 18 2
