width 20
height 20
............@@......
..........@.@@......
.......@............
..@....@.......@....
....................
.@..........@.@.....
........@....@......
@..@................
@@..@..........@.@..
......@..@..@.......
..@.................
...........@........
....@...@.......@...
...............@....
....................
.....@.@............
....@...............
.@.@......@....@....
.........@...@......
....................
5
5 1 0
17 6 0
15 11 1
10 7 1
0 3 2

7 13 0
17 1 0
0 5 1
0 19 1
17 5 2
