width 20
height 20
@@.............@@...
..............@.....
....................
.....@..............
...@.............@..
..........@....@....
...@...@.....@......
................@...
.....@..............
.........@......@...
..........@.........
...@.@..............
...............@....
........@..@........
....@.....@....@...@
.............@.....@
....@.@............@
............@.......
.............@......
@.@.................
5
5 19 0
3 18 0
1 13 1
3 2 1
18 8 2

6 10 0
18 1 0
5 16 1
3 16 1
1 18 2
