width 20
height 20
....................
.................@..
....................
.......@.@@@........
....................
....................
..@..@..............
....@...........@...
...........@........
..@.........@.......
......@.........@...
.@...@........@.....
....................
.........@..@.......
.@....@.............
....................
.@...@....@...@.....
.@.....@@...........
..........@...@.....
....@..............@
5
16 9 0
13 18 0
15 16 1
1 18 1
2 19 2

19 4 0
1 10 0
15 16 1
9 6 1
18 15 2
