width 20
height 20
.............@...@@@
..................@@
........@.@.........
...@................
@.......@.@.......@.
.................@..
.....@..............
.......@......@.....
............@.@..@..
................@...
....@...............
...........@..@.@...
..@.................
................@...
..@............@....
..........@.@.......
.....@..............
.......@............
@...........@.......
@@..................
5
1 1 0
10 9 0
13 17 1
2 13 1
12 1 2

1 5 0
17 1 0
13 17 1
13 13 1
13 1 2
