width 20
height 20
....................
.........@......@...
....................
....................
.......@.....@......
....................
.......@.......@.@..
..@......@..........
...............@....
........@......@..@.
.............@......
..........@.........
....@.............@.
......@@.......@....
.....@............@.
..........@.........
.......@............
.....@........@..@..
........@......@....
....@@..............
5
13 13 0
14 19 0
11 10 1
19 17 1
5 6 2

13 5 0
13 18 0
13 13 1
19 19 1
4 1 2
