width 20
height 20
@@@.................
@@.....@..@.........
..@.......@.........
..........@..@......
........@........@..
..@...@.............
....@....@..........
.....@........@.....
.@.......@..........
....@.@.......@..@..
.......@....@......@
.@............@.....
.........@..........
...@................
..@...@........@....
...@................
@...................
........@.@.........
....................
..@@................
5
2 11 0
4 2 0
9 14 1
3 16 1
6 6 2

8 12 0
14 8 0
14 14 1
17 6 1
17 12 2
