width 20
height 20
@@@@@@@@@@..........
@@@@@@@@@...........
@@@@@@@@...@.......@
@@@@@@@.....@......@
@@@@@@.............@
@@@@@@..............
.....@..@.....@.....
....................
...@.@...@.@....@...
......@.............
...@.............@..
.......@............
............@.......
...@.......@...@....
..@....@............
........@..@..@.@...
....@.............@@
..................@@
............@.....@@
............@@@.....
5
7 9 0
10 5 0
8 9 1
16 1 1
0 13 2

7 10 0
1 15 0
9 12 1
15 10 1
2 18 2
