width 20
height 20
....................
....................
@.............@.....
........@....@...@.@
.....@.........@....
....................
.............@......
@@..@.@@..@.......@.
@..@................
@..........@....@...
.......@......@.....
....@...............
..........@..@....@.
....................
.....@.........@....
@@@@....@...@.......
@@@@@@..............
@@@@@@.......@.....@
@@@@@@@............@
@@@@..............@@
5
8 10 0
15 1 0
13 7 1
12 19 1
10 0 2

0 0 0
16 8 0
11 19 1
10 3 1
14 19 2
