width 20
height 20
@@@.................
@.................@.
.............@@..@..
.@........@.........
......@....@.......@
............@......@
.........@........@@
..@.@...@.........@@
.........@...@..@..@
......@...@........@
@...............@..@
....@.@.............
....................
....@.@....@........
...@..........@..@@.
@@.............@....
@@....@.............
@@.......@....@..@..
@@..................
@@..................
5
18 5 0
7 19 0
8 8 1
17 13 1
14 12 2

9 7 0
6 12 0
17 19 1
8 3 1
0 2 2
