width 20
height 20
......@@............
...............@.@..
....................
.....@....@.........
............@..@....
....@...............
..........@.......@.
@@..................
....................
...@.........@......
....................
............@...@.@.
...............@....
..@.................
.@........@.........
......@.........@...
....................
....@.......@.@.....
@...................
@...................
5
14 14 0
13 7 0
6 2 1
8 6 1
16 2 2

6 11 0
11 7 0
14 5 1
7 5 1
0 11 2
