width 20
height 20
@..................@
@@.@...............@
...................@
..............@....@
........@......@..@@
..........@.......@@
...@.@.....@........
.@....@.@.@..@......
...@................
.........@....@.@...
....@...@...........
....................
..@.@......@........
.....@...@......@...
@...................
..@.................
@.......@...@.......
..@...@..@..........
.............@@..@@.
............@@@..@@@
5
13 12 0
3 2 0
19 7 1
11 15 1
5 0 2

7 2 0
7 4 0
13 14 1
17 0 1
16 14 2
