width 20
height 20
...............@@...
.......@@...........
.@.....@..........@.
...........@........
.....@.......@......
........@..@........
.....@............@.
..@.................
.........@..@.@.....
...@.....@..........
....................
.............@......
....................
....@..@............
.........@...@.@....
..............@.....
....................
....................
....................
....................
5
1 18 0
15 19 0
1 15 1
15 13 1
17 2 2

16 19 0
0 4 0
11 2 1
0 17 1
13 5 2
