width 20
height 20
....................
....................
..@.................
.......@.....@@...@.
..@....@............
.......@....@.......
....................
..@.@.@..@...@..@...
....................
.........@..........
..@.................
.........@........@@
............@..@....
.........@........@.
@...................
@...........@.......
@....@.@..@.........
@...@............@..
..@@@..@......@.....
@@@@@...............
5
5 4 0
15 8 0
10 2 1
5 19 1
5 7 2

2 1 0
16 12 0
12 10 1
14 7 1
0 8 2
