width 20
height 20
............@@@...@@
.......@.....@@....@
.....@.......@@@@...
.............@......
....................
..@...@........@....
.....@........@.....
.@.@........@.......
@......@............
......@.@...........
....................
..@......@..@.@.@...
....................
...@.@........@.....
.................@..
...........@....@...
.....@...@....@.....
....@...............
..............@.....
@@@.........@......@
5
2 16 0
15 10 0
17 16 1
0 11 1
7 13 2

6 12 0
15 14 0
8 8 1
0 9 1
13 17 2
