width 20
height 20
..........@@........
....................
..@.....@...........
...@........@...@...
..........@.........
....@.@.......@..@..
..@.................
...........@...@.@..
.@.....@.@..........
...@......@.........
......@.............
...........@.@......
...@........@.......
......@.............
...........@...@....
.@..@....@.........@
............@.......
@..............@....
@@..................
@@......@...........
5
16 14 0
8 11 0
18 17 1
13 14 1
7 10 2

5 2 0
18 0 0
7 15 1
10 10 1
0 2 2
