width 20
height 20
@@.................@
@@.@.....@..........
............@.@.....
......@.........@...
....................
....................
....@..@............
...@....@.@...@..@..
.........@.@.@......
..@.@............@..
..............@.....
@...........@.......
@....@.@........@...
..........@.........
...@........@.......
..........@......@.@
.@...@.@............
....................
...@.....@...@..@...
...........@@@.....@
12
10 8 0
8 17 0
7 11 0
4 16 0
9 5 0
16 10 0
17 8 0
8 14 0
2 18 0
15 14 0
4 10 0
6 15 0

12 10 0
4 19 0
8 11 0
2 15 0
19 3 0
9 12 0
2 18 0
18 3 0
18 19 0
1 15 0
5 11 0
15 10 0
