width 20
height 20
@@..................
@@@.........@.......
....................
....................
.@...@............@.
...........@.....@..
...@................
..@......@..........
.......@........@..@
..............@....@
.........@..@.@...@.
....@...............
.........@.....@....
......@.............
.@.@................
@@......@...@.......
@@..................
@......@.......@....
....................
............@@......
12
18 9 0
2 10 0
17 4 0
15 13 0
13 18 0
1 6 0
11 17 0
10 2 0
3 12 0
11 15 0
15 19 0
13 0 0

18 9 0
1 3 0
16 5 0
13 3 0
7 14 0
2 4 0
0 4 0
19 13 0
16 0 0
0 8 0
12 13 0
0 19 0
