width 20
height 20
..@............@....
............@.......
...@...@..@.....@...
.................@..
.@.....@............
............@.@..@..
....................
.........@..........
..@.@.....@.........
....................
...@..........@....@
.....@.....@.@.....@
....................
.@..............@...
@............@......
...............@....
@.@.....@..@........
@...................
@@.@.......@@@......
@@.......@@@@@......
12
6 0 0
11 10 0
16 9 0
15 8 0
12 17 0
16 17 0
15 14 0
2 14 0
10 14 0
16 12 0
9 2 0
9 0 0

6 1 0
13 1 0
7 14 0
15 8 0
19 16 0
8 18 0
16 14 0
19 2 0
19 0 0
3 17 0
5 1 0
5 0 0
