width 20
height 20
....................
..............@.@...
...@........@.......
....................
@.@....@...@@.......
.....@.....@........
..@.@....@.@@.......
................@...
....@.......@.....@.
...........@..@.@...
...@....@...........
............@...@...
..@..........@......
........@...........
....@.....@...@.@...
..@..@.........@..@.
.............@......
....................
.....@.@..@......@..
.........@..........
12
2 13 0
2 9 0
17 2 0
4 17 0
19 1 0
6 9 0
16 19 0
14 15 0
15 18 0
3 6 0
9 5 0
16 4 0

2 13 0
0 15 0
16 3 0
1 14 0
18 1 0
2 16 0
10 13 0
13 15 0
6 18 0
2 14 0
1 18 0
7 15 0
