width 20
height 20
.@@@@@..............
...........@...@....
..........@.......@.
.............@......
.........@.@........
...@.........@......
.........@......@@@.
..@.................
...........@........
.......@@.....@.....
.......@.........@..
...@.@....@.........
......@.........@...
..@.................
...@...@....@.......
@........@......@...
.@@..........@...@..
....@...............
....................
.....@..@...........
12
1 7 0
2 2 0
13 12 0
13 10 0
19 1 0
4 5 0
18 7 0
3 16 0
6 17 0
16 3 0
13 8 0
13 0 0

8 5 0
4 5 0
2 3 0
4 12 0
12 15 0
16 14 0
1 17 0
18 7 0
3 8 0
14 3 0
10 19 0
8 11 0
