width 20
height 20
.........@@@@@@@@...
.....@....@@@@@@@...
............@.......
..@..@.........@....
..@.....@.@..@......
............@.......
.....@.........@....
...........@....@...
@.........@.........
..........@@........
.......@............
................@...
.........@.@........
........@..@.@.@.@..
..@.................
....@..........@....
......@..@..........
.....@..............
....................
....................
12
7 1 0
7 8 0
15 8 0
4 13 0
10 3 0
2 13 0
18 16 0
9 3 0
12 12 0
1 2 0
3 19 0
6 2 0

4 3 0
17 19 0
11 4 0
13 3 0
6 0 0
5 18 0
17 14 0
7 2 0
12 10 0
0 4 0
6 18 0
6 2 0
