width 20
height 20
.......@.........@..
..........@.@.......
...@................
.@..@.@..@@.......@.
.........@..........
..........@.........
..@..............@.@
......@.............
....@......@........
....................
...........@.....@..
.......@............
.................@..
...@....@...........
...........@........
............@.......
.@.....@............
................@...
....................
.....@..@...........
12
7 17 0
5 9 0
3 0 0
12 9 0
8 14 0
10 17 0
5 18 0
11 6 0
17 16 0
4 2 0
4 9 0
1 13 0

7 12 0
19 19 0
19 16 0
3 14 0
17 1 0
16 12 0
6 17 0
10 6 0
14 13 0
2 5 0
10 19 0
9 1 0
