width 20
height 20
....................
....................
....................
............@.......
.......@............
.@..@.........@.....
...........@........
.@..................
.....@.@....@.......
@.......@...@..@..@.
....@...............
.@....@.............
..@.............@...
....................
@.@..@..............
@.....@....@...@....
@...................
....................
......@.............
...............@@@@@
12
2 9 0
7 11 0
11 5 0
15 13 0
12 13 0
9 5 0
2 4 0
11 19 0
7 18 0
6 16 0
17 9 0
0 18 0

17 8 0
3 6 0
13 13 0
17 2 0
13 18 0
6 10 0
18 17 0
14 15 0
18 6 0
6 16 0
0 8 0
7 13 0
