width 20
height 20
@@..................
@...................
.@..................
....@...........@...
@...............@...
........@....@....@.
........@...........
.............@.@....
.@....@...@.....@...
........@...........
................@...
....................
@........@..........
.......@.....@......
..@.............@.@.
..............@.....
.....@.....@........
.................@..
....................
.......@.@.........@
12
10 10 0
2 2 0
0 19 0
3 10 0
4 10 0
9 10 0
7 3 0
11 9 0
7 2 0
6 9 0
16 11 0
5 4 0

12 10 0
19 16 0
6 18 0
15 1 0
11 18 0
11 11 0
5 4 0
10 12 0
11 2 0
15 2 0
15 11 0
6 13 0
