width 20
height 20
....................
........@......@....
.............@......
......@....@........
....@@..........@...
...@.@...@..........
.................@..
...........@........
.................@..
..............@.....
.......@...........@
...@................
....@...@..@........
.....@..............
...........@..@.....
@......@............
....@...............
.........@......@...
..................@@
........@...........
12
8 3 0
12 9 0
16 3 0
7 11 0
0 2 0
19 9 0
11 19 0
9 0 0
3 10 0
15 19 0
4 1 0
13 14 0

7 3 0
7 4 0
17 11 0
19 4 0
10 16 0
17 16 0
17 0 0
18 16 0
4 10 0
7 11 0
10 0 0
1 5 0
