width 20
height 20
..............@.....
@....@..............
@........@.@.......@
................@..@
...@...............@
..@..@....@..@......
......@.......@.....
.............@..@...
....@......@........
..@...@........@....
.......@....@...@...
@...@...............
...........@........
.......@............
@.@..@..............
@..@.......@.......@
..................@@
...@....@@..........
.....@..@@..........
.......@@@........@@
12
8 9 0
19 7 0
11 11 0
2 3 0
18 12 0
1 10 0
10 11 0
16 19 0
12 5 0
5 2 0
15 13 0
17 2 0

10 16 0
18 5 0
16 11 0
11 19 0
5 11 0
5 9 0
13 3 0
15 7 0
0 16 0
13 19 0
7 12 0
17 1 0
