width 20
height 20
.....@@@@@@.........
.....@@@@@.@........
..............@.....
.....@...@.....@....
.....@.........@@...
.....@..@.......@.@@
..................@@
......@..@........@@
@@...@.........@..@@
....................
...@......@.........
.....@..............
..........@..@......
....................
.....@..............
..........@.@..@.@..
........@..........@
@@.................@
@@@.............@...
....................
12
6 5 0
11 5 0
19 9 0
5 17 0
2 3 0
7 12 0
8 3 0
1 12 0
14 13 0
7 13 0
10 5 0
10 1 0

19 19 0
14 0 0
13 18 0
17 8 0
10 6 0
18 15 0
11 12 0
0 0 0
6 3 0
19 0 0
4 19 0
10 4 0
