width 20
height 20
....@@.......@......
....................
@@........@...@.....
@@...@............@.
@@.........@....@...
@@@.............@...
@@@@...@....@....@..
@@@@..........@.@...
@@@@......@.........
.......@...@.@.@....
..@..@..............
.@..................
............@..@....
........@.@.........
..@.@.@..........@..
..............@.....
........@...@....@..
......@...@.........
..........@@..@...@@
...@..............@@
12
14 13 0
12 3 0
0 17 0
12 13 0
11 14 0
10 6 0
15 17 0
14 16 0
1 1 0
2 3 0
8 18 0
1 10 0

6 10 0
8 7 0
1 17 0
1 9 0
10 14 0
1 13 0
18 0 0
8 10 0
15 18 0
19 14 0
9 16 0
11 2 0
