width 20
height 20
@@................@@
@..@................
@..........@........
...@............@...
......@........@...@
.....@....@.@.@....@
..................@.
.@..............@...
..@.................
................@...
............@.......
@.@..@............@.
.................@..
...........@.@......
....@..@............
........@.....@.....
....@...........@...
..@......@@.........
.............@......
....@......@@.......
12
0 16 0
11 17 0
19 1 0
11 10 0
15 7 0
18 16 0
3 13 0
19 6 0
1 2 0
19 8 0
5 12 0
14 2 0

17 8 0
4 0 0
0 13 0
3 0 0
15 6 0
12 4 0
15 8 0
1 11 0
12 15 0
6 14 0
7 0 0
16 10 0
