width 20
height 20
......@@@...........
@....@.@@...........
....................
...............@....
..@..@..............
...@.....@.@.......@
......@.......@...@@
@.@............@...@
...................@
@....@........@....@
..........@..@..@..@
.@....@.@...........
....................
......@..@....@.@...
@...@..@............
.....@.....@........
....................
....@....@..........
.................@..
..@........@@.......
12
8 7 0
1 3 0
14 18 0
11 2 0
0 8 0
2 2 0
18 9 0
2 6 0
9 19 0
1 13 0
12 11 0
12 4 0

7 7 0
14 17 0
14 15 0
3 18 0
19 14 0
16 19 0
16 15 0
9 4 0
19 0 0
13 0 0
18 9 0
1 19 0
