width 20
height 20
....................
....................
....@.......@.......
......@.@.....@.@...
..................@.
.............@......
.@...@@.@..@........
..........@.....@...
...@..@.............
...................@
...@....@....@......
..@..@......@.......
...........@........
....@....@..........
.@.............@.@..
.......@....@.......
....................
....................
........@@..........
@.................@.
12
10 19 0
1 15 0
4 5 0
8 11 0
11 14 0
15 19 0
16 15 0
17 17 0
0 9 0
5 0 0
8 14 0
16 6 0

19 4 0
19 6 0
0 6 0
4 10 0
9 14 0
10 19 0
9 10 0
16 19 0
0 3 0
1 2 0
16 4 0
7 12 0
