width 20
height 20
....................
..................@.
.....@....@.........
........@...........
............@.@.....
.@..................
............@.@..@..
.....@....@.........
.@.@....@...........
.@.....@.......@....
....................
........@...........
...@................
....@..........@.@..
.....@....@..@......
@@.....@............
@..........@.@......
@...................
....@...............
....................
12
0 19 0
7 16 0
2 12 0
11 9 0
2 8 0
12 19 0
3 18 0
5 8 0
10 0 0
0 8 0
13 9 0
1 2 0

6 17 0
2 11 0
19 2 0
19 12 0
7 13 0
3 1 0
0 11 0
18 12 0
13 6 0
0 3 0
18 19 0
18 14 0
