width 20
height 20
..@.................
..@........@........
....................
.....@...@.........@
.................@..
.......@............
.........@..........
................@...
............@.......
.........@..@.......
.....@.@........@...
.....@@.............
............@.......
..........@.........
.@.@.............@..
....@.....@.........
@......@.........@..
...@.........@......
...............@....
....................
12
18 16 0
9 17 0
16 4 0
5 2 0
11 14 0
1 7 0
12 15 0
16 16 0
14 11 0
19 12 0
16 19 0
2 7 0

8 19 0
16 5 0
10 1 0
18 17 0
11 15 0
12 18 0
16 19 0
16 16 0
14 12 0
11 7 0
3 3 0
8 18 0
