width 20
height 20
....................
..@.................
........@....@......
.....@...@..........
............@..@....
....................
....@.........@.....
.......@........@...
..@.............@...
........@..@........
...................@
...@..............@@
.....@.....@........
.....@..@.......@...
............@.......
........@...........
................@...
...@.@....@...@.....
.@..................
....................
12
19 14 0
18 14 0
0 1 0
13 11 0
8 10 0
19 17 0
8 0 0
17 12 0
2 16 0
15 17 0
13 15 0
15 0 0

11 19 0
17 14 0
0 2 0
3 0 0
0 1 0
5 1 0
19 18 0
5 14 0
15 11 0
4 1 0
9 4 0
8 16 0
