width 20
height 20
@@............@.....
@....@..............
....@@..@......@....
....................
..@.....@...........
.................@..
......@..@.@...@....
@........@@.......@.
@..@.@...@@.........
.................@..
............@.@.@...
..@@...........@....
..@@................
...........@.@......
......@..........@..
....................
..@......@.....@....
.....@.@............
....................
....................
12
15 3 0
16 15 0
5 4 0
17 4 0
6 4 0
13 2 0
0 14 0
13 0 0
4 17 0
0 16 0
4 8 0
4 1 0

2 2 0
19 15 0
15 1 0
6 10 0
0 5 0
15 9 0
7 2 0
6 13 0
17 16 0
8 1 0
12 13 0
10 0 0
