width 20
height 20
...................@
..@.@...............
....................
.................@..
....@....@.....@....
....................
.....@..............
..@.......@..@...@.@
.@..@...............
..........@.........
...@............@...
...@..@......@..@...
............@....@..
.@..................
.@.....@............
..@.................
......@.............
..@.................
...........@@@..@...
..........@@@@......
12
4 11 0
1 16 0
12 5 0
13 12 0
19 1 0
6 3 0
13 15 0
5 2 0
19 2 0
19 5 0
4 2 0
0 7 0

6 0 0
5 15 0
0 5 0
2 11 0
13 12 0
5 2 0
12 6 0
12 11 0
1 5 0
5 4 0
16 15 0
12 7 0
