width 20
height 20
........@...........
................@.@.
..@..@...@...@......
...@..@...........@.
...........@........
..............@.....
@@....@.............
@@..@...............
@@........@....@..@.
....@..@@@...@......
......@@@@@.......@.
......@@...@........
@.............@.....
................@...
....@......@.....@..
..@....@.....@.@....
......@...@...@.....
....................
...........@........
...........@........
12
8 13 0
7 2 0
16 11 0
9 12 0
13 12 0
14 18 0
0 10 0
5 10 0
15 5 0
7 8 0
19 14 0
17 3 0

14 3 0
18 19 0
13 7 0
18 0 0
4 8 0
5 1 0
0 11 0
12 1 0
6 14 0
19 19 0
2 7 0
13 3 0
