width 20
height 20
...@................
..@.@...@...........
.........@..........
......@.@.....@.....
...@.@.......@......
........@...........
@................@..
...@....@...........
....................
.........@.@........
...............@.@..
.@..@..............@
...............@...@
..@.@....@........@@
.....@............@.
....................
...@........@...@...
.............@.@....
.@...@@@............
...@@@@@............
3
4 8 0
14 19 1
12 9 2

13 6 0
14 19 1
13 9 2
