width 20
height 20
............@.......
........@...........
...@................
....@...............
.........@..@.@.@...
.@......@..@...@....
......@.............
.............@......
....@.....@....@....
@...................
@.@.@..........@....
.........@.......@..
..@........@........
......@.............
...@........@...@...
..................@.
.......@.@..@.@..@..
....@...@........@..
@.................@.
....................
3
9 9 0
16 0 1
8 10 2

19 8 0
2 9 1
16 9 2
