width 20
height 20
....................
@.....@..@......@...
...................@
.@...@.@.......@...@
........@@..........
.......@.........@.@
..............@.....
...@.@..............
.........@..........
@.......@...@..@.@..
.......@............
..@..........@.@....
.........@..........
.................@..
............@.@.....
.........@..........
..........@.........
...........@...@....
...@..........@....@
..........@.......@@
3
0 19 0
0 3 1
18 17 2

0 4 0
19 17 1
17 17 2
