width 20
height 20
.......@@........@..
.................@..
...@.........@.@....
..........@.........
..@.@...............
.@.......@.....@....
........@........@..
....@.........@.....
........@.@.........
.....@.@.......@....
...@.....@........@.
...........@....@..@
....@...............
..@......@..........
....................
....................
.....@....@..@......
.............@.....@
.......@............
............@@@.....
3
15 8 0
9 17 1
12 13 2

1 0 0
16 12 1
2 18 2
