width 20
height 20
@@..................
@@.@.....@..........
...................@
.............@.....@
......@.@...........
.@..................
.....@.@.@.@....@...
...........@........
...@..........@.....
...@..@.@......@....
....@....@........@.
.@...........@......
.........@..@.......
..........@.......@.
................@...
......@.............
.............@...@..
..@.....@......@..@.
......@.............
....................
3
3 0 0
16 5 1
11 9 2

5 18 0
0 19 1
19 13 2
