width 20
height 20
.....@..............
.@....@.............
...........@..@.....
.....@.@............
.................@..
..@......@..........
.......@...@.@...@..
..@.............@...
....@......@.@......
.@.....@.......@....
................@...
.....@...@..........
..@.........@.......
.......@..@.........
.....@...@..@....@..
....................
....................
....@......@.@.@....
......@......@@.....
.............@@.....
3
19 9 0
11 7 1
8 18 2

2 6 0
11 7 1
18 0 2
