width 20
height 20
....................
......@....@........
........@...........
..@......@.....@....
......@..@..........
...@......@.@...@...
..............@.....
..........@.........
..@...........@.....
..........@.........
.@..............@...
....@...............
.......@............
..........@.........
.......@............
...@.....@.......@..
..@.@...........@...
...........@........
..............@.....
....................
3
12 13 0
7 18 1
1 12 2

5 0 0
11 8 1
15 16 2
