width 20
height 20
@@..................
@@......@....@..@...
.....@.@@...........
......@.....@.......
...@.....@..........
..@.........@.......
..........@...@.....
.....@.......@......
..@.............@...
....................
....................
.@@..@.@.@..@.......
....................
.......@..@.......@.
..@....@.....@.@....
............@.......
..........@.........
.......@.......@....
@@.............@@...
@@..................
3
4 18 0
9 6 1
15 3 2

4 1 0
19 18 1
15 2 2
