width 20
height 20
....@@@.@@@@.......@
........@........@..
...........@.@......
...@.......@........
..@.....@...........
..........@.@...@...
....@...............
..@..@...@......@...
......@.......@@....
.........@...@......
...@................
.......@..........@.
...@.....@.......@..
....@.@.....@..@....
.....@.......@......
...@................
..@...@....@........
........@...........
.....@..............
.........@..........
3
10 15 0
18 14 1
19 15 2

10 14 0
8 14 1
19 15 2
