width 20
height 20
................@@@@
.................@@@
.............@...@@@
..................@@
....@.....@.......@@
..............@.....
....................
......@..........@..
....@........@...@..
....................
.......@............
........@.@....@....
......@....@........
....................
....@.@.............
...@..............@.
..............@.....
....@...........@..@
....................
............@.......
3
9 14 0
0 4 1
8 7 2

19 7 0
2 19 1
8 5 2
