width 20
height 20
......@@........@...
..@@................
......@....@.......@
..@..@.@...........@
.........@..@.......
.............@.@.@..
@......@...@.......@
@..@.........@......
....@...............
....................
....................
.....@...@..........
............@...@...
.@....@....@........
.............@......
....@.@...........@.
.........@......@...
...........@........
....................
.................@.@
3
13 16 0
3 13 1
5 16 2

13 18 0
3 4 1
17 3 2
