width 20
height 20
@..................@
....@..............@
@........@..@.......
@...................
....................
....@.....@..@.@....
....................
.@....@..@....@.@...
.@..................
....@...@......@....
...........@....@@..
...@@...............
......@.....@...@...
.@.@....@...........
............@.@.....
...@..@.............
.........@..........
....@@@...@...@.....
.@.@@@@..@...@...@..
@@@@@@..............
3
12 19 0
5 8 1
12 3 2

6 19 0
12 7 1
18 19 2
