width 20
height 20
..................@@
....@.....@.........
....................
@.....@.............
..@.@.....@.........
...@...@............
.............@..@...
....................
@.........@.........
@..@...@....@.......
@....@...@..........
@.......@.......@...
..............@.....
....................
............@.......
.........@....@.@.@.
.....@..............
........@..........@
......@.............
.@...........@......
3
7 8 0
9 3 1
9 19 2

10 0 0
7 17 1
19 6 2
