width 20
height 20
@@..@.@@@@@.........
@@....@@@@@...@.....
@.....@@@@...@...@..
......@@@@..........
.@......@....@..@...
....................
....@......@.....@..
..................@.
......@.@.....@.....
..@....@.......@....
.@..................
@...@........@......
...............@....
.@....@..@...@...@..
....................
......@...@.........
....@.........@.....
.@@.................
@@@.................
@@@.................
3
7 14 0
0 4 1
2 3 2

7 14 0
12 19 1
19 8 2
