width 20
height 20
....@...............
....@..........@....
@...................
........@....@......
..........@.....@...
@............@...@..
...@.....@..........
..@...............@.
...@................
..@@...........@....
.@.....@..@..@......
....................
..@........@.@...@..
...............@....
..@...@......@......
...@..........@.....
......@..@.........@
.......@...@.......@
....@...............
.......@@........@..
3
1 18 0
9 18 1
4 3 2

0 10 0
3 13 1
15 14 2
