width 20
height 20
@.........@@@.......
....................
............@.......
.....@..............
...........@........
..@.................
....@.........@.....
...................@
............@.......
.@...........@......
........@.........@.
..........@.........
.@.@.........@......
....................
......@....@........
.............@......
..@....@.@..........
...@.......@........
.............@......
................@...
3
2 18 0
13 10 1
19 13 2

16 4 0
10 5 1
12 7 2
