width 20
height 20
........@..........@
......@....@........
......@@......@.....
@@.................@
@@.....@...........@
@@@@@.....@.........
@@@@@........@..@...
....................
....@..........@....
.............@....@.
.@..@..@..........@@
.........@....@@..@@
...............@..@@
......@..@.@........
...@...........@....
...........@....@...
.......@....@.......
@...................
...........@.@......
....................
3
13 3 0
10 11 1
13 19 2

11 16 0
16 12 1
2 11 2
