width 20
height 20
......@.............
........@...........
............@.......
...............@....
.......@............
..........@.@.......
.....@..............
........@.@...@...@.
............@.......
....@..............@
....@......@....@...
.....@...@..........
...........@........
..............@.....
...@....@.@.....@...
..............@.....
...........@........
..@..........@......
...............@@...
.....@@@@.........@@
3
8 10 0
17 2 1
9 6 2

0 18 0
11 2 1
7 7 2
