width 20
height 20
...........@@...@@@.
....@....@......@...
....................
.............@......
...@....@...........
................@...
@.@....@.....@......
@...............@...
.@..................
.@..........@..@..@.
.......@............
.....@..............
..@.........@...@...
.......@...@....@...
@.....@@........@...
@.........@.........
@...@..@............
...........@..@.....
....@...............
...................@
3
6 17 0
10 14 1
15 2 2

1 14 0
1 1 1
6 17 2
