width 20
height 20
....................
@.@.........@.......
.....@..............
....................
....................
....................
.....@....@.....@...
@@...............@..
.............@......
..@.................
...@...@....@..@....
......@...@.........
..@.................
...........@.@...@..
........@.....@.....
....................
.@@.........@.......
.@@.....@...........
@@@.................
@@@.......@@........
3
12 13 0
16 5 1
3 15 2

4 15 0
14 4 1
5 17 2
