width 20
height 20
.........@@.........
...............@....
.@.@.....@.@........
.......@............
.............@......
...@.@..............
....................
.....@.@...@...@.@..
.@..................
.@........@...@.....
................@...
.......@......@.....
....................
.....@..@......@....
.................@..
..@............@...@
...........@........
....@....@..........
....................
..@......@@@........
3
1 18 0
6 18 1
15 6 2

13 12 0
19 5 1
8 5 2
