width 20
height 20
@@@................@
.@@......@..........
........@...........
....................
...@.....@..........
.......@............
..@...........@..@..
...........@.@......
...@....@...........
@............@.@....
.............@......
.....@..............
........@.........@.
...@................
............@..@....
....................
.@...@....@......@..
..............@.....
..........@.....@...
....................
10
17 14 0
4 0 0
7 2 0
16 3 0
8 6 1
19 6 1
12 5 1
2 11 2
9 9 2
8 9 2

2 7 0
10 11 0
1 17 0
17 10 0
7 3 1
0 11 1
4 19 1
2 12 2
16 4 2
7 9 2
