width 20
height 20
....................
.@...............@..
.............@.@....
.@..@...............
............@.@.....
.....@...........@..
..@@................
..@@.@...@..........
.................@..
....................
..@...@.............
........@.....@.....
..........@.........
...@...@............
........@.....@..@..
.....@.......@......
.......@.......@....
...@................
@........@..........
...........@@@......
10
12 8 0
8 17 0
4 4 0
7 3 0
11 9 1
14 2 1
5 18 1
8 2 2
13 18 2
18 12 2

6 1 0
4 17 0
19 17 0
5 3 0
11 9 1
15 1 1
7 18 1
16 10 2
14 7 2
1 0 2
