width 20
height 20
@........@.....@@...
...@................
..@.......@...@.....
.............@@.@...
....................
..........@........@
.....@.@......@....@
@.@.....@.@......@.@
@..........@........
...@..............@.
.............@......
..........@.........
.....@............@.
..@.............@..@
@..@................
@.......@...........
....@.....@.........
...@........@.......
......@@@...........
@.....@@@...........
10
2 10 0
7 9 0
1 0 0
10 17 0
2 14 1
17 4 1
11 7 1
9 8 2
14 5 2
13 13 2

19 8 0
12 5 0
4 11 0
5 11 0
19 0 1
4 3 1
10 4 1
9 8 2
15 12 2
15 8 2
