width 20
height 20
......@@............
@.....@@............
.......@............
..........@.........
.@.........@...@....
..............@.....
..@.@............@..
...@...@............
...........@......@.
..@.@...@....@......
.......@....@@......
......@.......@.....
....................
..@......@..@...@...
@@..................
@@............@.....
......@..@..........
.....@..@.@.........
....................
....................
10
12 9 0
15 15 0
12 1 0
1 18 0
13 18 1
3 19 1
12 3 1
1 8 2
11 14 2
9 18 2

0 19 0
3 0 0
18 10 0
4 15 0
1 0 1
16 15 1
19 17 1
5 11 2
19 0 2
18 1 2
