width 20
height 20
.......@@..........@
..@.........@......@
.............@.@...@
...@.....@..@.......
..@.@..............@
.........@..........
..............@.....
...@..@.............
....@...@......@.@..
.........@..........
@.....@.............
@.@.................
@............@......
@...................
.......@.@......@...
..................@.
.........@...@......
...@................
...............@....
..@............@...@
10
0 16 0
5 8 0
1 3 0
13 11 0
15 14 1
17 17 1
5 14 1
12 16 2
3 6 2
3 11 2

19 16 0
4 11 0
18 7 0
14 3 0
1 19 1
17 17 1
12 16 1
13 8 2
7 7 2
18 1 2
