width 20
height 20
.................@@@
...................@
..@.................
....................
.....@........@..@..
...........@........
.....@..............
.@..@......@.....@..
...@....@.@.@.......
....................
........@.@.........
..@.................
....................
...............@....
....................
.....@.@....@.......
...@....@...........
...........@........
....@...............
....@..@............
10
3 15 0
15 7 0
4 10 0
4 11 0
16 16 1
18 3 1
5 13 1
2 9 2
5 14 2
10 1 2

7 3 0
7 17 0
4 13 0
19 9 0
8 0 1
18 3 1
6 13 1
19 19 2
1 11 2
2 10 2
