width 20
height 20
....................
....................
.......@.....@......
........@.......@@..
.........@........@.
....@......@...@....
..@.........@.......
......@.............
...........@........
.......@.@....@.....
............@.......
.....@..............
...........@........
.......@..@.@.@.....
...@................
.................@..
......@........@....
@@@.@.@.............
@@@@@@@.............
@@@@@@@.............
10
8 4 0
2 15 0
19 7 0
1 2 0
6 0 1
16 18 1
19 4 1
16 11 2
13 9 2
11 7 2

11 7 0
14 10 0
0 10 0
1 2 0
11 16 1
18 0 1
10 4 1
14 8 2
5 2 2
19 19 2
