width 20
height 20
@@@@@@.@@..@@...@@@@
@@@@@.........@.@@..
@@@@@...@...........
@@.......@..........
....@.@........@....
........@...........
.........@...@.@....
..........@.........
................@...
...@...@.........@..
....@...............
............@.......
....................
.......@........@...
.....@..@........@..
....................
..........@.........
.....@..............
......@...@.........
......@@............
10
10 1 0
17 17 0
17 18 0
12 7 0
0 19 1
3 6 1
11 15 1
13 2 2
7 7 2
4 14 2

1 14 0
16 19 0
9 5 0
14 2 0
5 15 1
18 19 1
1 4 1
7 11 2
15 17 2
19 12 2
