width 20
height 20
....................
...@.........@......
.....@..........@...
....................
..@.@.....@.........
....................
..@......@..........
....................
..@..@..............
........@.@.@.......
.....@..............
....@..........@....
...............@....
........@...@.@....@
.@........@.........
....@..........@....
...........@........
....@..@............
...........@@......@
.......@@..@@......@
10
9 11 0
4 9 0
12 14 0
10 13 0
14 9 1
3 4 1
13 11 1
13 3 2
11 14 2
16 14 2

2 1 0
11 10 0
0 1 0
19 2 0
9 13 1
8 0 1
10 8 1
5 19 2
19 10 2
16 14 2
