width 20
height 20
......@@............
@........@..........
.......@.......@....
....................
.....@.@.......@....
................@...
...@.....@..@@......
@...@...@...@.......
@..........@..@.@...
@......@..@.........
...............@....
...@.......@.......@
....@....@..........
..@.................
........@.........@.
....................
..@...@...@.........
....................
....@....@...@......
................@..@
10
16 18 0
11 4 0
6 3 0
5 5 0
15 16 1
13 11 1
13 3 1
2 8 2
14 9 2
15 13 2

16 17 0
10 0 0
1 0 0
9 13 0
12 15 1
0 11 1
0 4 1
9 2 2
11 3 2
1 11 2
