width 20
height 20
......@.......@...@@
......@...@.......@@
....................
..........@.........
.....@......@..@....
......@.............
.....@......@..@....
...@@....@..@.......
...@.............@..
..@....@.@.......@..
..........@.........
....................
.@..................
...@................
......@...@.....@...
....................
....................
.......@.@..........
@.......@.....@@....
@.............@@....
10
14 1 0
6 3 0
16 16 0
18 17 0
11 2 1
16 18 1
15 14 1
16 1 2
5 1 2
18 3 2

8 17 0
8 6 0
10 0 0
17 11 0
19 12 1
9 1 1
12 14 1
3 16 2
6 6 2
16 17 2
