width 20
height 20
@...................
.............@......
...@.....@....@.....
..........@.....@...
....@...@.......@...
..................@.
......@....@........
...@.@....@..@......
........@...........
.....@.............@
........@....@......
@...................
@.@..@......@......@
@.....@@@...@.......
@.........@.........
...@.....@......@...
...........@@..@.@..
.........@........@.
...@....@...........
....................
10
17 19 0
10 1 0
14 10 0
5 17 0
17 14 1
19 8 1
13 16 1
15 12 2
8 1 2
10 12 2

18 15 0
12 7 0
0 1 0
9 1 0
17 14 1
4 9 1
5 1 1
9 9 2
17 18 2
10 12 2
