width 20
height 20
..............@.....
....................
....................
.......@.........@..
.@......@..@........
...............@....
....@.....@.........
@.............@.....
@.@.....@...........
@...........@..@.@..
@...................
...........@.....@..
.....@.@............
@..@......@...@.....
@...........@.......
................@...
........@...@.....@.
..@.................
.........@..@.......
@.....@@@@..........
10
19 19 0
19 4 0
13 18 0
19 16 0
2 19 1
5 0 1
16 14 1
11 18 2
8 18 2
18 1 2

17 5 0
4 3 0
7 0 0
0 2 0
18 1 1
2 16 1
8 15 1
2 7 2
17 1 2
19 3 2
