width 20
height 20
@@.............@....
@@............@.....
....................
.........@..........
...........@.....@@.
..@..........@...@@.
.........@..........
@...@............@..
...@..@..@....@.....
....................
......@.............
...........@...@....
....................
.......@....@.......
@............@......
@...................
....................
.....@......@@......
...@..@.....@@......
............@@......
10
7 14 0
13 16 0
13 10 0
14 3 0
11 6 1
8 8 1
7 5 1
5 19 2
3 13 2
7 9 2

10 1 0
5 2 0
14 4 0
18 6 0
11 5 1
12 6 1
19 18 1
17 3 2
18 3 2
15 3 2
