width 20
height 20
..................@.
@..........@....@...
@@..................
@@....@..@...@......
...............@.@..
..@.............@...
............@.......
...........@..@.....
..@..@..............
....@..@............
.........@..@.......
..@.................
...............@....
........@..@........
..@...@.............
.@...........@.@....
.......@............
..@.@...............
..........@@.....@@@
..........@@@@..@@@@
10
8 12 0
19 9 0
17 9 0
4 19 0
8 16 1
7 12 1
18 1 1
13 5 2
13 6 2
3 11 2

10 10 0
0 17 0
9 18 0
3 15 0
13 6 1
12 17 1
7 10 1
1 19 2
14 15 2
5 9 2
