width 20
height 20
..............@@....
.........@..........
.................@.@
...@....@..@.......@
.....@.........@....
.....@..............
......@.............
.........@..........
...............@....
....................
.@.....@....@.......
.............@......
.......@............
........@.......@...
...........@........
....@...............
.......@.@...@......
....................
........@@..........
.......@@@@@........
10
1 16 0
17 5 0
2 0 0
16 12 0
0 7 1
3 12 1
7 6 1
18 11 2
0 2 2
13 14 2

2 14 0
0 18 0
10 0 0
0 2 0
2 2 1
17 7 1
19 18 1
10 13 2
16 15 2
0 7 2
