width 20
height 20
@@@.....@@@@@@@@..@@
..@...@.@@@@@@@.....
..........@@@@@.....
.......@......@.....
.........@..........
........@...........
............@.......
...........@......@.
........@.@.........
....@...............
..............@.....
....@......@..@..@..
....................
.....@.....@........
.........@.....@....
....................
.................@..
..@.@..............@
.....@..............
...........@........
10
6 12 0
9 19 0
13 9 0
5 15 0
2 13 1
9 17 1
19 6 1
19 16 2
7 9 2
6 4 2

5 15 0
3 1 0
1 17 0
10 9 0
4 18 1
5 0 1
19 12 1
15 11 2
5 19 2
4 10 2
