width 20
height 20
...@.........@@@....
....................
........@...........
.................@.@
.@.@.@....@@........
.....@......@.......
.....@.........@..@.
.................@..
.........@..........
..@...............@.
...@..........@.....
.....@...@..........
........@......@....
.......@............
....................
........@.@......@..
..............@.....
.....@..@..@........
...............@....
@..........@........
10
17 14 0
1 2 0
16 3 0
5 1 0
18 11 1
3 6 1
13 15 1
6 10 2
16 19 2
2 13 2

11 2 0
18 18 0
4 8 0
13 1 0
2 2 1
0 9 1
1 6 1
12 19 2
3 12 2
19 11 2
