width 20
height 20
@@@@@@@.............
@@@@@@@........@....
.@@@@@@...@.........
...@@@@..@..........
.....@..............
..@.........@.......
.............@......
...@...........@....
.....@..@...........
............@.....@@
......@....@..@...@@
...@.....@.......@..
...........@...@....
.......@............
...........@........
....................
.........@..........
.........@...@......
....@....@.......@..
@......@............
10
5 7 0
10 14 0
14 12 0
14 17 0
8 19 1
16 4 1
11 0 1
4 7 2
3 19 2
15 17 2

14 15 0
11 16 0
12 3 0
16 17 0
18 17 1
18 15 1
0 14 1
5 10 2
1 16 2
17 16 2
