width 20
height 20
@@@@@@@.............
@@@@@...............
@@@@@.......@.@..@..
@@@@@..@.@......@...
@...................
@.@......@...@......
..............@.....
....@...@...........
...@................
..........@.........
............@.@.....
.@..................
.............@.@....
.......@............
.....@.....@........
..............@.....
.......@..........@.
.....@.....@..@.....
....................
..........@@........
1
13 3 0

13 15 0
