width 20
height 20
..................@@
....@..........@...@
.@....@...@...@.....
..@.............@...
....@...@...........
....@@....@....@....
@...................
@.@..........@......
..@...@.............
...............@....
............@.......
....................
........@...........
.............@......
...@................
.........@....@.....
....................
.........@.........@
..@.....@........@.@
..................@@
1
19 9 0

18 7 0
