width 20
height 20
...@@...............
..@.@.......@@......
....................
.......@..@.........
...@..........@.....
......@.............
.....@.....@........
...............@....
@@@.......@.........
@@@...........@.....
...@.........@......
.........@........@.
..........@......@@.
.................@..
............@.......
...@................
........@...@.@.....
..........@.........
....@...........@.@.
..@@................
1
8 9 0

6 14 0
