width 20
height 20
......@@...........@
......@@...........@
@...........@..@...@
@....@.............@
..@.................
................@...
.....@...@..@.@....@
....................
.........@....@.....
....................
..@.................
................@.@.
....@...@...........
............@.......
@..........@........
@.........@.........
......@..@.@..@.@...
....@..............@
..@..............@.@
................@...
1
3 4 0

4 10 0
