width 20
height 20
..@@......@.........
....................
....@........@...@..
...@................
......@@............
..........@.@.......
...@.............@..
..@.................
........@....@......
@@........@.........
..................@@
..@...............@@
............@.@....@
@.........@.........
@...@......@....@...
......@...@.........
....................
.........@..........
............@.......
@..............@....
1
2 10 0

19 19 0
