width 20
height 20
....................
...............@....
....................
....................
....................
........@...........
@..@........@.......
@@@@.......@...@....
@@@@........@.......
@@@@....@.........@.
@@@@..@.....@...@...
...@.......@........
.............@..@...
..................@.
....................
.............@......
..@.................
....@.....@@....@...
...@@...............
@..@@...............
1
2 1 0

10 1 0
