width 20
height 20
@@...@@............@
....................
......@..@..........
...............@....
...............@....
....@....@.@.@......
...............@...@
@.....@.......@....@
.........@..........
............@.......
........@......@..@.
.....@..............
.......@....@.......
........@....@......
......@.........@...
....................
............@.....@.
....@@@@.@......@@@@
...@@@@@.....@..@@@@
...@@@@@@.........@@
1
1 6 0

14 8 0
