width 20
height 20
@.@.................
@...................
.......@.@..........
...@............@...
....@...............
....................
....................
.......@......@.....
.@..................
.........@...@......
....................
....................
......@..@.....@....
....................
...@.@...@.@........
@@...........@......
...@.....@..@..@...@
.......@.....@..@...
....................
..@.................
1
12 4 0

7 8 0
