width 20
height 20
....................
...@...@............
.@..@.....@.@.......
................@...
.............@......
.......@...@.....@..
...............@..@.
..@.@...............
....................
........@...@...@...
.............@......
....................
@....@...@..........
..@.............@...
.......@............
.@.......@..@.......
.....@..............
.......@..@...@..@..
...........@........
....................
1
5 8 0

2 2 0
