width 20
height 20
@...................
..................@.
........@...@..@....
..@.@.....@...@.....
.....@....@.........
.................@..
....................
.....@.@.@..........
........@...........
..@........@........
......@.....@.......
........@...........
..@..........@......
.......@............
...@....@...........
...........@........
...@...........@....
@@.......@..........
@......@.........@@.
....................
1
19 6 0

3 17 0
