width 20
height 20
................@@@@
.......@...@....@@@@
.................@@@
.........@...@......
...@................
.....@...@.....@....
.............@......
..................@.
...............@....
.............@......
......@.@@..@......@
....................
....@..@...@....@...
...........@.....@..
...@.......@.@......
......@...@.....@...
...@.@........@.....
.......@............
.....@.......@......
.....@..............
1
16 5 0

4 15 0
