width 20
height 20
..............@@@@@@
..............@....@
...@.......@.@......
@.........@.........
....................
....@....@....@.....
.....@.....@...@.@..
......@.............
..@.......@...@.....
................@...
.......@...@.....@..
....................
....@......@.@......
..............@.@...
.........@.......@..
....@...............
@..............@....
....@...............
...@.....@..........
....................
1
13 0 0

10 2 0
