width 20
height 20
.....@....@@........
....@...............
...........@........
..............@.....
..@..@...@.@.@......
....@.@.............
..........@..@......
@....@..............
....@........@......
................@...
....@.@..@..........
...........@........
..............@...@.
.....@..@......@....
..........@.........
..@.................
......@..@....@.....
...@.@..@....@......
.................@..
....................
1
7 12 0

4 6 0
