width 20
height 20
............@.......
............@.......
........@...@.......
.........@@.........
........@@@.........
........@@@........@
..............@.....
.....@.........@....
....................
.......@.@......@...
....@..............@
.................@..
......@...@.........
..@.@...............
..........@......@..
.........@..........
...........@........
........@....@..@..@
...........@........
....................
1
6 0 0

19 11 0
