width 20
height 20
@@@.................
@@@..............@..
@@@...@....@........
@@@@@.........@.....
@.@@..........@@....
@....@..............
.........@..........
..............@..@..
............@.......
...@................
..@........@........
....@.....@..@....@.
@@..@............@..
.....@..@.@...@@....
....................
...............@....
@@......@...........
.............@@.....
@.........@@@@@@...@
@......@..@@@@@@...@
1
3 15 0

18 6 0
