width 20
height 20
.@@....@...........@
.......@............
............@...@...
....................
....@.@......@......
...@.....@..........
.......@.....@...@@@
....................
............@....@..
..@.....@...........
.....@...@..........
................@...
............@..@@...
..................@.
.@.....@...@..@.....
@@..@...@...........
@@........@.........
@@...............@..
@...................
@...................
1
8 4 0

9 4 0
