width 20
height 20
........@...........
.................@..
..............@.....
..@........@.@......
...@...@.........@..
.........@..@..@....
...@..@.............
..@.@.....@...@.@...
....................
@......@...@..@.....
...@................
....@.......@.......
.@......@.@.........
............@.@....@
...@.@..@..........@
..........@..@.....@
..@........@.......@
....................
........@........@..
....................
1
17 6 0

4 8 0
