width 20
height 20
....................
..........@.......@.
............@.......
@...............@...
...@..@...@.........
..@..@..@...........
.............@..@...
.....@......@.......
...............@....
..@..@...@....@.....
...............@....
...@.@.....@......@.
....................
.@...........@.@....
.......@.......@....
...@.......@........
................@...
.....@@.............
...@@@@@............
...@@@@@.......@....
1
0 12 0

14 3 0
