width 20
height 20
.......@............
.............@......
.........@.@........
....................
...@....@...@..@....
.@..@.........@...@.
.........@..........
....................
..@.@.@@@...@.@...@@
......@@@.........@@
........@...@....@@@
....................
..........@...@.....
..@............@....
..............@.....
....................
.@..@.......@....@..
@@@...@.............
...............@....
@.........@@........
1
3 17 0

7 4 0
