width 20
height 20
.........@@@........
..........@@........
.....@..............
.................@..
.........@..........
.............@......
.@.....@............
......@........@....
.......@....@.@.....
....@...........@...
...........@...@....
........@...........
...........@...@....
..@..............@..
...@....@.@.@.......
.....@...@...@..@...
......@@............
.....@@.............
...@..........@....@
@@.................@
1
12 17 0

15 14 0
