width 20
height 20
@@...........@......
@@@@......@.........
@@@@..............@.
@@@..@....@.@.......
@@@..........@..@.@@
@@.@.@............@.
@......@.....@......
........@.@.@.......
...@................
.......@.....@.@....
....................
@.@..@.@...........@
....................
......@........@.@..
....@...............
......@....@.@...@..
.@...@....@.........
........@..@........
............@.......
.....@@....@@.....@.
1
0 9 0

1 12 0
