width 20
height 20
@..............@....
@......@....@.......
...@..@............@
@.........@......@..
..@.................
..........@.@.......
..................@.
....@..@......@.@...
.....@..............
..@..........@....@.
......@....@........
@...................
@...................
......@.@...@..@....
....................
......@.@.........@.
.@...@....@...@..@..
.@.....@............
....................
...@@...............
10
3 7 0
2 0 0
8 4 0
13 7 0
6 12 0
17 2 0
3 0 0
7 11 0
5 12 0
16 15 0

2 3 0
12 17 0
4 13 0
13 7 0
19 1 0
17 2 0
7 8 0
16 10 0
6 14 0
0 4 0
