width 20
height 20
....................
....@.........@.....
......@.............
....................
............@..@..@.
...@................
.@...@..............
....................
...........@...@....
..........@.........
............@.......
...@...@............
@@...@..@....@..@...
@@@......@..........
@@.........@........
@@..............@...
@@.............@....
@....@..@...@.......
@@..................
@@@@................
10
19 9 0
19 14 0
10 13 0
6 17 0
17 5 0
3 9 0
5 13 0
1 17 0
7 0 0
8 9 0

1 0 0
17 1 0
13 1 0
6 7 0
17 3 0
12 3 0
5 9 0
19 19 0
16 1 0
18 3 0
