width 20
height 20
....................
.........@.@........
....@..@............
...@..@.........@...
@............@...@..
@..@................
...@...@...@........
....@........@...@..
........@...........
.....@..............
.@...............@..
@...........@.@.....
....................
........@.@...@.....
......@..@..........
.@....@.............
...............@....
....@.........@..@..
....................
....................
10
1 16 0
3 11 0
13 19 0
16 11 0
19 19 0
7 16 0
10 17 0
5 8 0
16 2 0
8 4 0

10 8 0
12 16 0
5 14 0
0 10 0
8 5 0
17 6 0
13 10 0
12 10 0
10 17 0
5 7 0
