width 20
height 20
.................@@.
@.......@...........
@..@..........@.....
@.......@...........
........@...........
...@.........@....@.
...................@
....@...............
.......@.@..@..@....
....@...............
.@........@.........
...@..@.........@.@.
........@......@....
....................
....@........@......
..@..@..@.@.........
....@@..............
........@...@.....@@
..............@.....
.......@............
10
9 12 0
0 7 0
14 11 0
16 17 0
18 4 0
17 3 0
13 1 0
18 10 0
17 17 0
8 13 0

19 2 0
1 7 0
16 4 0
16 14 0
11 13 0
18 7 0
9 12 0
7 1 0
13 0 0
6 3 0
