width 20
height 20
....................
.@..............@..@
............@.......
.........@..........
....................
.....@....@.........
..@........@......@@
...@...............@
...............@....
..@......@..........
....................
.@...@.........@....
....................
...@..@.......@.@...
....@...............
.........@..@.......
.....@.@............
..............@.....
..............@.....
@@@.......@........@
10
6 16 0
2 15 0
17 3 0
1 15 0
13 5 0
16 18 0
6 18 0
0 7 0
9 6 0
18 15 0

19 10 0
2 8 0
11 2 0
15 2 0
6 17 0
16 16 0
1 18 0
18 16 0
1 15 0
2 0 0
