width 20
height 20
..@.................
....@...............
.@...............@..
.@.......@..........
....................
..........@....@....
...........@........
......@...@......@..
..@.@...............
...............@....
.....@...@.@........
..........@.........
.....@..............
..@...@......@...@..
........@...........
....................
........@.@...@.....
....................
..@..@..............
....................
10
1 11 0
6 0 0
11 1 0
13 19 0
18 12 0
13 15 0
18 3 0
6 1 0
19 16 0
15 2 0

17 14 0
4 11 0
15 2 0
10 15 0
4 4 0
18 14 0
5 0 0
14 15 0
2 12 0
8 0 0
