width 20
height 20
..............@@...@
.......@..........@@
...@@......@......@@
...................@
....@...@...@..@....
......@..........@..
...@......@.........
..@.................
....................
....................
...@....@.....@.@...
.@....@.............
@@...@@....@........
....................
............@.....@@
..................@@
..@...@...........@@
..................@@
.......@............
....................
10
4 19 0
19 4 0
11 0 0
2 19 0
19 13 0
7 17 0
12 9 0
1 14 0
4 8 0
9 13 0

5 13 0
19 19 0
17 0 0
17 1 0
18 10 0
12 16 0
2 19 0
15 2 0
0 11 0
15 6 0
