width 20
height 20
...............@@...
...............@....
...@.......@........
...........@........
...@..@....@......@.
..........@.........
........@.@....@....
.@..@..@......@.....
@..@...............@
@.....@.............
.....@@........@....
.......@............
..@......@..@...@.@.
....................
...@................
.....@.....@..@.....
.@.....@...@.@......
....................
..@.................
............@.......
10
11 8 0
15 15 0
10 10 0
0 7 0
1 13 0
16 18 0
0 13 0
7 18 0
10 9 0
17 9 0

0 19 0
2 0 0
1 3 0
1 9 0
17 3 0
11 11 0
17 13 0
7 19 0
19 17 0
15 19 0
