width 20
height 20
....................
.......@...@........
@.........@@@@...@..
@...@.....@@@@@@....
............@@@@@...
..............@@@...
@...@.@.......@.....
.......@..@.........
....................
.....@..@.@.@.......
.................@.@
....................
.....@..........@...
.......@...........@
..@...........@....@
.......@..@.........
......@........@....
@@.........@.@......
@@.................@
@@.........@........
10
8 1 0
13 13 0
1 9 0
13 11 0
17 6 0
0 8 0
4 18 0
17 5 0
6 10 0
5 16 0

2 5 0
6 5 0
16 6 0
19 6 0
18 15 0
8 1 0
4 9 0
17 5 0
6 10 0
0 1 0
