width 20
height 20
....@........@......
....................
..@....@.........@..
....................
....@..@............
.........@@.........
..@.................
......@......@.@....
..@........@.....@..
......@.............
.....@..........@...
.............@......
.....@..@...........
..@.@.....@...@.....
...@.............@..
.@.........@...@....
.......@............
..........@..@......
....@@.........@...@
....@............@@@
10
7 13 0
7 10 0
11 18 0
12 4 0
12 2 0
1 1 0
17 6 0
15 3 0
7 19 0
14 9 0

17 0 0
17 6 0
19 4 0
10 3 0
12 1 0
2 5 0
17 7 0
1 10 0
5 6 0
14 5 0
