width 20
height 20
.............@@.....
....................
..........@........@
.....@@............@
....@@@.............
.............@......
.........@..@.@.....
....................
.................@..
....@.........@..@..
.@.....@............
...........@.....@..
....@...............
.@....@........@....
............@.......
...@....@.@.........
.....@......@......@
..@..........@......
...................@
............@.....@@
10
13 16 0
4 8 0
11 6 0
11 0 0
18 15 0
17 7 0
1 7 0
16 0 0
5 5 0
3 17 0

7 16 0
5 18 0
12 8 0
9 1 0
2 13 0
8 19 0
10 4 0
11 0 0
13 19 0
19 0 0
