width 20
height 20
....................
....................
......@..@...@......
....@.....@.........
...@..@...........@.
.....@....@.....@...
....@...............
.........@.....@@...
....@...............
......@..@.@..@.....
....................
....@......@...@....
.@..................
................@...
......@.@..@...@....
...@................
.............@......
......@.........@...
.......@......@.....
......@.............
10
12 3 0
2 0 0
13 0 0
17 10 0
14 7 0
9 10 0
12 16 0
11 19 0
0 18 0
11 12 0

14 3 0
1 6 0
13 6 0
1 13 0
7 2 0
8 10 0
11 16 0
14 1 0
5 13 0
13 9 0
