width 20
height 20
....................
....................
....................
...@.@......@.......
..@@.....@.@..@..@..
..@.....@...........
.......@...........@
.@..........@.@.....
...............@....
.......@.@..........
.@....@.....@...@...
...................@
......@.@..........@
..........@.........
..............@.....
@...................
@@@.................
@@@@.....@..........
@@@@@......@.@@@....
@@@@@.......@@@@....
10
18 3 0
3 6 0
0 11 0
2 15 0
9 18 0
2 12 0
4 8 0
8 14 0
14 17 0
5 18 0

13 13 0
4 6 0
4 9 0
3 1 0
0 12 0
16 11 0
14 15 0
8 14 0
13 10 0
7 18 0
