width 20
height 20
....................
.....@..............
....................
.........@@.......@.
.....@...@..........
............@.@.....
....................
......@...@........@
..@.................
...@.....@@...@.....
.@..................
.......@@........@..
...............@....
...@..@.............
.......@...@........
...@................
.......@..@.....@...
........@....@......
.@...@..............
....................
10
7 7 0
15 17 0
2 4 0
18 1 0
8 1 0
11 5 0
16 10 0
5 5 0
14 16 0
13 1 0

7 7 0
17 18 0
0 8 0
4 14 0
9 0 0
3 4 0
6 2 0
18 19 0
17 15 0
14 10 0
