width 20
height 20
..........@...@@....
....................
...@.@..............
..............@.....
....@..@....@.......
...........@....@...
..@.....@...........
....@.@.............
.......@..@@........
..........@....@..@.
.@............@.@@..
.....@..............
....................
................@...
..................@.
...@........@.......
..@.@.....@....@...@
.............@......
.........@..........
....................
10
13 19 0
2 3 0
12 5 0
2 11 0
18 11 0
16 0 0
1 19 0
15 13 0
2 14 0
0 15 0

2 0 0
6 15 0
3 18 0
2 12 0
18 11 0
15 5 0
14 17 0
15 14 0
5 14 0
0 15 0
