width 20
height 20
..............@@@@@@
................@@@@
.@.@...@.........@@@
....@...@.@..@...@..
..............@.....
.................@..
....@.............@.
..........@..@.@....
...@..@....@........
...............@....
......@@...@........
.@.......@..........
...........@........
...............@....
.........@..........
....................
.@......@.@.@.@.....
.....@..............
.....@....@.....@...
@@..................
10
3 9 0
16 8 0
19 8 0
10 17 0
3 0 0
5 15 0
0 6 0
12 0 0
16 7 0
8 10 0

6 19 0
19 11 0
14 1 0
10 17 0
8 9 0
11 7 0
0 9 0
12 0 0
9 1 0
19 17 0
