width 20
height 20
@.@@.............@@@
..@@............@@@@
........@.......@@@@
................@@@@
......@@...@....@@@@
..........@.....@@@@
...........@....@@@@
................@@@@
...@............@@@@
.......@.......@@@@@
......@..........@@@
.....@...........@@@
.......@.......@....
..............@.....
...@.@..............
.......@........@...
...@....@......@....
....................
.........@......@...
.............@......
10
7 13 0
18 16 0
11 5 0
0 1 0
7 14 0
3 2 0
11 3 0
10 1 0
5 7 0
7 2 0

3 2 0
13 5 0
18 16 0
3 7 0
8 7 0
13 11 0
12 18 0
1 9 0
17 16 0
19 19 0
