width 20
height 20
@@.@.......@.@@....@
.@...@.@@.@.....@@@@
...@..@@@...@.@@@@.@
@@..@.@@@@.@.@@@....
@..@.@.@@.......@.@.
@@.......@.@.@@.@@..
@..@@.@@..@.@.@.@.@.
@@...@...@..........
@@@.@@@.@.@.@@@@.@@.
@@@@@@@@......@.@@.@
@.@@@@@@@.@@.@......
@.@.@@@.@...@@@.@.@.
.....@...@.@.@.@@@..
.@@.@@@.@.........@.
@....@...@.@.@@.@...
@@.@@.@.@...@.@@.@.@
@........@@.......@@
.@@.@@.@....@@.@.@@@
......@.@.@..@@.....
@.@.@....@@@.@@@.@.@
3
12 4 0
18 12 1
7 19 2

9 11 0
11 7 1
4 0 2
