width 20
height 20
.@@...........@.@.@@
....@.@.@@@.@......@
@.@.@@.@.@.@.@@.@.@@
..@@.@.....@...@@..@
.@.....@.@..@.@.@.@.
...@@@..@..@........
.@@..@@.@.@@@.@.@@.@
@@.@...@.@@@@.@..@@@
@....@....@@.@@@.@@@
..@.@@@.@....@.@..@@
@.@..@.@@.@@.....@.@
@.@@.@..@@...@.@.@..
..@@@@@....@@.@....@
.@@@.@.@.@..@.@.@.@.
.......@@.@@...@....
@.@.@@.@..@@@@..@.@@
...@.....@.@...@@...
@.@..@.@.....@.@.@.@
@..@..@@@.@@.@@@....
..@@@.@@@@@@@....@.@
3
9 18 0
19 16 1
8 4 2

1 9 0
8 3 1
1 11 2
