width 20
height 20
@@@@@@@@@@@..@@@@@@@
@@@@@@@@@.@.@@@@@@@@
@@@@@@@@@....@@@@@@@
@@@@@@@@@.@.@@.@@@@@
.@.@@@@@@@.......@.@
...@@@@@@@.@.@.@...@
.@.@.@@@@@@@@@@@.@@.
@....@..@@.@.@.@....
.@.@@.@..........@@@
........@.@.@.@@@...
@@@.@.@.@.@.@.@@..@.
@....@@@.@.@.@...@.@
@@.@..@........@.@..
@@@..@.@.@@.@.@..@.@
@@.@.@...@.@@@.@....
@......@.@..@@...@.@
.@@.@@.@@.@..@.@@@@@
.@..@.@.@.@.@...@..@
...@.........@.@.@..
.@...@.@@@@@@......@
3
4 15 0
18 14 1
16 6 2

11 2 0
10 14 1
12 8 2
