width 20
height 20
@@@@.@...@@@@@@@..@.
@@@...@.@.@@@@@..@..
.@.@.@....@@@@.@.@.@
......@@@...........
.@@@@@@.@@@.@.@.@.@.
...@..@...@.@@.@.@.@
@.@.@...@...........
......@..@@.@.@@.@.@
@.@.@.@@.@@@.@....@@
...@.@..@.@..@@.@.@@
@@...@.@..@@.@..@.@@
.@.@...@.@....@..@.@
..@..@.@.@@.@...@...
.@@.@..@.@@@..@@.@.@
.....@...@@@@.......
.@.@@.@.@@@.@.@@.@@@
@..@..@.@@..@..@....
@@@..@.@@.@.@.@.@@.@
@@.@..............@@
.....@.@.@.@.@.@@@@@
3
3 17 0
17 8 1
4 2 2

1 3 0
7 16 1
4 17 2
