width 20
height 20
@@@@..@@@....@......
.@@@.@.@.@.@...@.@.@
..@.........@.@.@@@@
.@@@.@.@.@.@@....@@@
..@.@...@@@@@@@.@@@@
@.@.@@.@@@.@@@...@@@
.....@@@@...@.@@..@@
.@@@@.@.@.@......@.@
..@@@......@.@.@@...
.@@.@.@.@.@.@@...@@.
.......@.....@.@@@..
@.@@@.@.@.@.@.@.@.@.
@.@@....@.@.........
.@..@.@.@..@.@.@.@.@
..@...@@.@@@@@@@@...
@.@@@.....@@@@@@.@.@
@..@@@@@@.@@@@@@....
..@.@.....@@@@@@@.@.
@.....@.@@@@@@@@@@..
@@@.@..@@@@@@@@@@@@.
3
2 6 0
10 2 1
10 6 2

18 13 0
0 13 1
8 8 2
