width 20
height 20
@@@@@..........@@.@.
@@@@@@.@.@.@.@..@...
@@@@@@.@.@..@..@@@.@
@@@@@...@..@@@..@...
@@@..@.@.@@@@@@..@@.
@@@.@@...@.@@@.@....
@@@....@.@......@.@.
@...@.@....@@@.@.@.@
@.@..@@@.@.@.......@
@@@@@@@@@.@..@.@.@..
@@@.@@@@...@.@@@@@.@
@@@.@@.@.@@@..@@.@..
@@...@....@@.@@....@
@@@.@..@@@....@@.@..
.@...@.@@@@@.@@...@@
..@.@....@.@@@.@.@@@
.@..@@.@.........@@@
...@.@@..@@.@.@.@@@@
.@.....@...@...@@@@@
..@@.@...@.@.@.@@@@@
3
2 14 0
8 15 1
17 1 2

12 19 0
19 1 1
17 6 2
