width 20
height 20
@.@.@@@@@@.@..@.@.@.
......@@@....@......
@.@@@.@@.@.@@.@.@.@.
@@...............@@.
@.@.@.@.@.@@.@.@@@..
@....@...@@@@..@@@@.
..@.@.@@..@..@.@@.@.
@..@.....@@@..@.....
..@@.@.@.@...@..@.@.
@..@..@..@.@.@.@.@@.
@@@@.@@@.@.@.......@
.@.@.@.@@.@.@.@.@@..
....@........@..@..@
@@@...@.@@.@..@@.@..
@...@@@@....@@.@...@
..@...@..@.@.@.@.@.@
@..@.@@@@.........@@
..@@..@..@@.@.@.@@@@
@...@...@@@@..@.@.@.
@@.@@.@..@@@@.@.....
3
1 0 0
0 1 1
5 3 2

15 17 0
15 16 1
13 18 2
