width 20
height 20
....@@@@.@.@.@@...@@
@.@..@..........@@@@
@@@.@.@@.@.@.@@..@@@
@@.......@@.@.@.@@@@
@@@@.@.@..@.....@@@@
@@....@@.@@@.@.@@@@@
@..@.@@@@@@...@@@@@@
.@..@@.@.@.@.@@@@@@@
...@..........@@@@@@
.@.@.@.@.@.@.@.@..@@
.@@.@.@.@@@......@.@
........@@@@.@.@.@.@
.@.@.@.@@@@...@@...@
..@.@..@@@@@.@.@.@..
.@....@@@@@@....@..@
@.@.@.@.@.@@.@.@.@..
...@@.......@.....@.
.@.@@.@.@.@.@@.@.@@.
@..@.@@@.@@..@..@..@
@@..........@@@...@@
3
0 9 0
2 12 1
16 0 2

9 8 0
12 8 1
9 19 2
