width 20
height 20
@@@.@.@.@....@..@@@@
@@@.....@@.@@..@.@@@
@@@@@.@......@....@@
@@@@@@@.@.@.@.@.@@.@
@@@@@..@@@..........
@.@@.@.@@@@.@.@.@@.@
...@....@.@@.@.@....
@.@..@@........@.@.@
....@@..@.@.@@@...@@
@.@...@@@@....@.@...
@@..@@..@@@.@@.@.@.@
@.@...@.@@@@.@......
...@@.....@....@.@.@
@.@...@.@@..@@@@@.@@
....@@.@@.@....@@..@
@.@....@....@.@...@.
@@@@.@..@.@@....@@..
@@@@@@.@.@@.@@.@@.@.
@@@@@...............
@@@@@.@.@.@.@@.@.@.@
3
14 14 0
6 5 1
18 18 2

13 9 0
6 4 1
4 9 2
