width 20
height 20
@@@@.@@@@@@@....@..@
@@.@.@@@@@@.@.@..@..
@@.@..@@@.@..@.@...@
@....@@.....@....@..
@@.@...@@.@@.@.@@.@@
@...@@@.@..........@
.@.@.@....@@@@@.@@..
.@.....@@..@@..@@@.@
...@@.@@.@.@.@..@.@@
@@..@.@........@@..@
.@.@.@@@.@@@.@.@..@.
......@..@@.@.@.@...
.@.@.@@@..........@.
@...@@@..@@.@.@@.@..
@@.@.@.@.@.@.@..@.@.
@..@...........@...@
@@.@.@.@.@@.@.@.@.@.
@@@...@@@..@@...@.@.
@@@@.@.@@@.@@.@.....
@@@@.......@@@..@.@.
3
0 6 0
2 7 1
8 19 2

2 6 0
4 14 1
14 9 2
