width 20
height 20
.@.@...@.@.@.@@.@@..
.....@...........@.@
.@@@.@.@.@.@.@.@.@.@
@...@.@.@@@.@.@....@
@@@......@..@..@.@..
@@@@.@.@...@@.@.@@@.
@@@.@.@.@@.@@.......
@@..........@@.@@@.@
@.@.@.@.@.@.@....@@.
.....@.@..@@.@.@....
@@.@....@..@...@@.@.
..@.@@@.@.@@@@.@.@..
@.@......@@@@.@....@
....@@@.@.@@@...@@..
.@.@@......@@@@...@@
@@@@@@.@@.@.@.@.@@@.
@@@@@@@@............
@@@@@@@@.@.@@.@.@.@.
@@@@@@@@@....@..@@..
@@@@@@@@@@.@@@@...@.
3
14 4 0
15 15 1
9 14 2

9 1 0
1 1 1
19 4 2
