width 20
height 20
@@@@@..@..@..@@@@@@@
@@@@@@.@.@.@.@@@@@@@
@@@@@.........@.@@@@
..@@@.@.@@.@.@@..@@@
.@.@.@..@.@..@@.@.@@
......@...@@........
.@@@.@@@@@.@.@.@.@.@
@@....@..@..@..@@...
@@@@.@..@@.@.@..@@.@
@@@....@.@.@...@..@.
@@@@.@.......@.@.@..
@@@@..@.@@.@.@@@...@
@@@..@.@@@.@@..@.@@@
@@.@....@@@...@....@
@@...@.@.@.@.@.@@.@.
@@@.@...........@...
@@...@.@@.@.@@.@@.@.
@@@.@.@@@@...@...@..
@@@@...@.@@.@.@.@.@.
@@@..@........@.....
3
5 11 0
11 18 1
4 7 2

12 17 0
15 4 1
7 8 2
