width 20
height 20
@@@@.@@.@.@..@@.@@@.
@@@.........@.......
@@..@.@.@.@...@.@.@.
@.@..@@@@@@@.@@@@@..
@.@.@.@.@@@@@.@.@.@.
.........@@@........
.@@.@.@.@@@@@.@.@.@.
@.@@..@..@@@...@@@..
.....@..@.@.@.@@@@@.
.@.@..@.@......@@@@.
@...@@...@.@@.@@@@.@
@@.@@@@.@.@....@@...
@..@@@@...@.@.@...@.
.@..@@..@@@..@@.@.@.
.@.@..@@....@@.@...@
.....@.@@@@.....@@..
@@.@@...@@..@@@....@
@@@@@.@@.@@...@.@.@@
@@@@........@..@....
@@@@.@.@.@.@..@@.@.@
3
6 8 0
9 0 1
0 13 2

6 18 0
18 11 1
12 15 2
