width 20
height 20
.....@@.@@.@..@@@.@@
.@@.@@@.....@..@...@
@.@..@@@@@.@..@.@.@.
....@...@....@......
@.@...@..@@@..@.@@.@
..@.@.@.@..@@.....@.
@..@...@.@....@.@@..
..@@@.@...@@@..@@@.@
@.@@@.@.@@.@.@...@.@
@..@....@.....@.@..@
..@.@.@...@@@.....@.
.@.....@@.@@@@@@@...
..@.@.@..@.@@@@.@.@.
.@...@@@.@..@@@...@.
.@@.@@@....@.@.@.@..
@@...@.@.@...@..@@.@
..@@.@.@@.@@.@.@@..@
@............@...@..
@@.@.@.@.@.@@..@.@.@
@@@..@@..@..@@@.....
3
14 5 0
12 9 1
12 2 2

10 13 0
7 19 1
8 18 2
