width 20
height 20
@@@@@.@@.@.....@@...
@@@@.....@@@@.@@@.@.
@@@@@.@@@@.@..@@..@@
@@.@........@.@.@...
....@.@.@.@.......@.
@.@@@@.@.@@.@.@@.@..
@.@@@..@....@@...@@.
...@@@...@.@@@@@@...
@.@.@.@.@.@@@@@...@.
....@.....@@@@@.@..@
@.@...@.@.@@@@@@..@@
@@..@..@...@@@@@@.@@
@.@.@.@@@.@@@@@@@@@@
....@@@@@@@@@@@@@@@@
@.@..@@@@@@@@@@@@@@@
...@@@@@@@@@@@@@@@@@
@.@@@@@@@@@@@@@@@@@@
@@@@@@@@@@@@@@@@@@@@
@@@@@@@@@@@@@@@@@@@@
@@@@@@@@@@@@@@@@@@@@
3
5 3 0
6 1 1
4 10 2

5 4 0
8 11 1
16 8 2
