width 20
height 20
@@.@@.@........@@@@@
@.......@.@.@.@@@@@@
@@.@@.@..@@@....@@@@
@@..@..@@.@.@.@.@@@@
@@.@@@@.@.@....@..@@
@.@.@.@.....@@..@...
......@.@@@@...@@.@.
@.@.@...@.@@@.@...@.
...@..@.@.@@@@@@.@@@
@.@@@..@...@@.@...@.
...@@.@@@.@....@.@..
@.@..@@@...@.@....@.
....@@@.@.@.@.@@@...
@.@..@@.....@.....@.
@@.@.@@@@@@.@.@@.@..
@....@@@@.@....@..@@
@.@.@.@.@..@@.@..@@@
...@......@.@..@.@@@
@.@.@.@@@.....@.@.@.
.........@@.@.......
3
17 5 0
18 19 1
4 17 2

16 11 0
11 19 1
11 3 2
