width 20
height 20
@@.@.@.......@.@.@@.
@......@@@.@........
@@.@@@....@..@.@.@.@
@@@.@.@.@@.@..@...@@
@@@...@.@....@@@.@..
.@..@..@@@.@@@@@...@
..@..@.......@@@.@..
.@..@.@@.@.@@.....@@
..@...@.@.@@.@@@.@.@
@.@@@.........@.@...
...@.@.@.@.@@.@.@.@.
@.@...@@@..@.......@
....@..@.@.@@.@.@.@.
@.@..@.....@.@.@....
@@..@.@.@.@@....@.@.
@.@....@@@.@.@@.@@..
....@@..@.....@...@.
.@.@...@@@.@.@..@@..
@...@.@.@...@.@....@
..@@@@....@....@.@..
3
13 12 0
3 13 1
14 11 2

13 3 0
14 13 1
6 16 2
