width 20
height 20
@@.@...@.@@.@@@@@@.@
@@...@.@.....@..@...
.@.@@.@.@.@.@.@.@@.@
..........@........@
.@.@.@.@.@@.@.@.@.@.
.@@..@@...@..@@@....
...@@@@@.@@@.@@.@.@.
@.@@@@@.@.@.@.@..@..
..@@@@@.........@..@
.@@@@@@.@.@.@.@..@..
@@@@@@.@@.@@.@..@.@.
@@@@@..@......@.....
@@@@@@...@@.@..@.@.@
@@@@@@.@..@..@@.@..@
@@@@@@..@..@@.@.@.@.
@@@@@@@.@.@.@...@...
@@@@@@@@......@.@.@.
@@@@@@@@@@.@.@@@@@..
@@@@@@@@@@.@@@@.@..@
@@@@@@@@@@.......@.@
3
7 7 0
16 11 1
5 0 2

9 9 0
2 1 1
11 13 2
