width 20
height 20
@@@.@@@..@.@..@...@@
@@@.@@.@.@...@.@.@@@
@..........@......@.
..@@.@.@@.@@.@.@@@..
@.@.@@@...@...@@@.@.
....@@@@.@.@@@.@....
@@@..@@.@........@.@
....@.....@.@.@.@.@.
.@@.@.@.@..@@@......
@....@@..@@@.@.@@@@.
@@@@....@@@.....@...
@@@..@.@...@@@@@.@.@
@@@@..@.@@.@.@.@....
@@@@@...@........@.@
@@@@..@.@@.@@@.@.@..
@@@.@@@...@@..@.@..@
@@......@@.@.@@..@..
@.@.@@@.........@..@
.......@.@@@.@.@.@.@
.@.@.@..@@@@..@.....
3
4 9 0
10 12 1
15 16 2

5 12 0
15 8 1
9 11 2
