width 20
height 20
@@@.@@@@@@@@@@@@@@@@
@@@..@@@@@@@@@@@@@@@
@@..@@@@@@@@@@@@@@@@
@.@.@.@.@.@.@@@@@@@@
.............@@.@.@.
.@@.@.@@.@@@@@......
...@...@@@@..@@.@.@.
.@.@@.@@.@.@..@..@..
..@@@@.......@.@@.@.
.@@@@@@.@.@.@..@....
..@@@@@@@.@@@.@.@.@@
.@.@.@.@@...........
..........@.@@.@.@.@
.@@.@@.@.@@@..@.@..@
...@.@.@@@@.@.@...@@
.@....@@@@......@.@.
@@.@.@.@@..@.@@@@@..
@.@@....@@.@...@@..@
.....@@@@@.@.@....@@
@.@.@@@@@...@..@.@@@
3
18 11 0
18 12 1
14 11 2

11 4 0
5 5 1
12 11 2
