width 20
height 20
......@@@...@.@.@.@.
@@@@.@.@@@.@......@.
.@......@...@.@.@.@.
...@.@.@@@@....@@...
.@.@..@.@.@.@@@.@.@@
..@..@@.........@...
@@.@.@.@.@.@@.@..@.@
.@...@..@@@@@@@.@.@.
...@.@.@.@@@@@......
.@@@.@....@@...@.@@.
..@.@.@.@@@.@@..@...
.@.............@@.@.
...@.@.@.@@@.@..@..@
.@@...@@@...@@@@..@.
@.@@.@.@.@.@@@.@.@..
............@....@@.
@.@.@.@.@.@.@@.@....
@@@@.@@@@@..@@@..@.@
@.@...@....@....@@..
@...@...@.@@@.@..@.@
3
11 3 0
12 18 1
0 3 2

17 12 0
8 8 1
4 11 2
