width 20
height 20
@@@@@@@@@@@@@@@@@@@@
@@@@@@@.@.@@@@@@@@@@
@@@@@@@...@@@@@@@@@@
@@@@@@.@@..@@@@@@@@@
@@@@@.....@@@@@@@@@@
@@@@@@@.@.@.@@@@@@@@
..@@@@@@....@@@@@@@@
.@.@..@.@@@..@@@@@@@
.@...@...@..@.@@@@@@
...@..@.@.@....@@@@@
.@..@.......@.@@@@@@
@..@@.@.@@@@.@.@@@@.
@@.@...@.........@..
@@@.@.@.@@.@@@.@..@.
@.........@...@.@...
..@@.@.@@..@.@@...@.
@...@@..@.@.....@@..
.@.@..@@.@.@.@@...@.
.....@.........@.@..
.@.@...@@@.@.@@..@@.
3
2 14 0
19 19 1
13 10 2

5 13 0
4 12 1
11 12 2
