width 20
height 20
@...@.@.@@@@@.@.@..@
..@......@@@......@.
.@..@@@@@@@@.@.@@...
@.@.@@.@..@...@.@@@.
.........@.@@...@...
@.@@.@.@......@..@.@
.@@@..@.@.@.@.@.@@@@
....@...@@.@@@.@@@@.
.@.@@.@..@..@@..@.@.
.@...@..@.@...@.....
.@.@@..@....@.@.@.@.
.@@.@@..@.@@.@@.@@@@
.......@.....@..@.@.
.@.@.@...@.@..@.....
@...@@@.@.@..@@@.@@.
@@.@@@@@..@.@.@.@...
....@@.@@.@...@.@@.@
.@.@@.......@.......
..@...@@.@.@@@@@.@.@
.@@@@..@..@@@@@@.@..
3
11 16 0
16 9 1
8 3 2

15 8 0
15 1 1
0 18 2
