width 20
height 20
@@.@.....@@.@@@..@@@
@..@@@.@.@...@.@..@@
..@.@...@.@.@....@.@
.@...@.@......@.@..@
...@.....@.@@..@.@.@
.@@@@@.@..@...@.....
@..@..@@@.@@@...@@.@
@@...@.@.@@..@@.@.@@
...@.....@.@.@@...@@
.@@..@.@.......@@.@@
.@.@.@@..@.@@.@....@
@.....@@..@@...@.@..
@@.@.@.@.@@.@@....@.
@...@.....@....@@.@.
@@.@.@@.@@@.@@..@@..
@....@.@.@@@@@@..@@.
..@@........@@@@..@.
.@@@@.@.@.@..@@@.@@.
..@.@..@@.@.@.@.@@..
.@....@@@.@.....@@@.
3
19 19 0
8 13 1
8 10 2

15 18 0
14 12 1
16 17 2
