width 20
height 20
@@@@.@.@.@@@.@.@.@@@
@@@.......@.......@.
.@.@.@@@.@..@.@.@...
.....@.@...@@..@..@.
.@.@....@.@...@..@..
@...@.@.@..@@..@.@@.
@@@.@@.@@.@@@.@@@.@@
@....@.@...@@..@..@.
.@@.@..@.@@@..@@@...
......@.@.@.@@.@@@.@
@@.@@...............
@@@@@@.@.@.@.@.@.@.@
@@@@@...@.@...@..@..
@@@@.@.@@.@@.@@@..@@
@@.....@.....@...@@@
@..@.@..@@@@@.@@@@@@
@@..@@@@.........@@@
...@@....@@.@@.@@@@@
.@.@.@@.@@@@....@.@@
.@......@@@@@.@...@@
3
10 3 0
9 6 1
13 8 2

9 9 0
8 11 1
14 17 2
