width 20
height 20
.............@....@@
......@.............
....................
....................
.....@.....@..@.....
@.......@.......@...
@.....@....@........
....@..@.....@......
....................
...@........@.......
.................@@@
....@.............@@
..@.................
......@.@....@......
..............@.....
...........@........
.@..................
...@...@............
...........@........
..@@................
13
17 17 0
4 0 0
4 9 0
4 18 0
14 13 0
0 12 0
5 12 0
17 19 0
9 18 0
7 6 0
4 1 0
17 1 0
19 1 0

19 15 0
16 18 0
18 15 0
1 4 0
16 3 0
10 14 0
15 16 0
2 2 0
1 6 0
6 18 0
4 1 0
12 16 0
19 6 0
