width 20
height 20
.........@..@......@
...@...............@
...........@........
........@.@..@...@..
.........@......@...
..@.................
....@....@....@.....
.............@....@.
......@.........@...
....................
....@.......@...@...
........@.........@.
....................
.....@.@.@.@........
.@..@...............
..............@.@...
@...@...............
...@........@.......
.......@............
....@...............
13
17 13 0
0 14 0
18 8 0
16 14 0
18 13 0
7 10 0
1 13 0
15 9 0
11 4 0
6 7 0
15 16 0
17 9 0
12 19 0

0 13 0
6 15 0
13 4 0
5 19 0
16 13 0
18 0 0
0 11 0
3 9 0
19 12 0
15 17 0
2 2 0
19 6 0
18 1 0
