width 20
height 20
@...................
....................
..........@....@....
...@..@.............
.........@........@.
..........@.@..@....
...........@........
........@.....@...@.
....................
..@.......@.@..@....
.......@............
....................
....@.@.....@...@...
....................
.....@..@....@...@..
...@......@.........
.........@.......@..
............@.......
..............@.....
..@@@@@...@.........
13
15 11 0
19 18 0
19 16 0
6 17 0
10 16 0
4 9 0
8 9 0
5 9 0
10 4 0
15 3 0
0 7 0
1 19 0
15 15 0

15 4 0
17 11 0
5 13 0
6 16 0
0 2 0
15 10 0
18 0 0
19 18 0
12 18 0
15 8 0
11 10 0
1 4 0
5 8 0
