width 20
height 20
....................
....................
......@.......@.....
....................
..................@.
...@..@.@........@..
....................
..@..........@......
.@............@...@.
......@...@.....@...
........@...........
......@.............
.@..................
........@....@......
.....@......@...@...
.@.....@............
...@.........@@.....
............@@..@...
.........@@@@.......
@..@.....@@@@.......
13
10 1 0
18 0 0
14 6 0
15 1 0
8 19 0
6 7 0
2 3 0
11 7 0
4 18 0
1 9 0
9 1 0
3 4 0
12 2 0

10 4 0
0 8 0
15 12 0
2 10 0
3 0 0
8 3 0
0 18 0
11 7 0
1 2 0
16 10 0
0 0 0
0 12 0
7 14 0
