width 20
height 20
......@.............
....................
.....@..............
.@..@.@..@...@...@..
.......@............
....................
....@.@.............
.....@.....@.@......
..............@.....
.......@............
....................
.........@..........
@....@....@....@@.@.
...........@...@@...
.......@............
....................
@...@.......@.@.....
@...................
@@@........@.......@
@@@@...............@
13
3 8 0
19 9 0
12 11 0
9 15 0
4 10 0
4 11 0
4 4 0
13 9 0
19 17 0
16 10 0
19 6 0
8 17 0
2 12 0

2 15 0
0 0 0
7 18 0
7 15 0
5 0 0
10 3 0
3 7 0
12 9 0
16 16 0
16 5 0
18 5 0
19 1 0
19 0 0
