width 20
height 20
@@@.................
@@@......@..........
@..............@.@..
@...................
...@.....@..........
....@...............
..................@.
...............@.@..
..........@.........
.....@..@...........
.................@..
...........@...@....
@.@.....@...........
...@..@......@......
....................
................@@@@
.@@..........@..@@@@
.@........@.....@@@@
...............@@@@@
.@.............@@@@@
13
17 13 0
15 16 0
10 14 0
0 8 0
18 10 0
13 1 0
19 10 0
8 10 0
6 6 0
9 16 0
16 7 0
7 8 0
19 12 0

17 13 0
16 14 0
5 4 0
19 10 0
7 15 0
2 10 0
14 10 0
9 10 0
13 6 0
9 16 0
19 1 0
16 1 0
9 8 0
