width 20
height 20
@...................
...@..@..........@..
................@...
.@.........@.....@..
.........@...@......
....................
....@.......@.......
.@.....@........@@..
..@.@...@...........
.............@......
.....@..............
.......@.@.@........
........@.......@..@
@..@................
.............@...@..
....@.......@.......
.......@.@..........
...@................
............@.......
...............@...@
13
5 13 0
10 11 0
14 15 0
13 1 0
2 0 0
10 6 0
8 1 0
16 13 0
2 16 0
6 8 0
19 0 0
5 7 0
7 18 0

18 2 0
2 1 0
8 18 0
13 1 0
12 1 0
13 5 0
18 4 0
7 2 0
17 19 0
12 2 0
5 7 0
17 17 0
19 2 0
