width 20
height 20
...........@...@...@
....................
......@..@....@.....
..........@..@...@..
....................
................@...
...@....@...@.@.....
...............@..@@
....@...............
....@...@...........
....................
.....@.@............
...@..@.....@.......
....................
......@.@......@...@
............@......@
.................@@@
....@..@..@......@@@
.................@@@
................@@@@
13
4 10 0
6 5 0
12 10 0
3 9 0
17 8 0
9 14 0
0 14 0
2 0 0
3 2 0
12 16 0
8 15 0
12 5 0
13 11 0

3 0 0
15 18 0
12 10 0
1 18 0
12 4 0
19 1 0
8 13 0
3 18 0
8 19 0
11 8 0
6 17 0
6 4 0
0 0 0
