width 20
height 20
....@......@.....@..
...........@...@....
....................
............@.......
....@..........@....
@.......@.@.........
............@.......
........@.......@...
.@..@...............
....................
........@....@......
.....@......@......@
.......@.@.@...@...@
....@.@..@..........
....................
...........@.@......
.....@...@..........
.............@..@...
....@...............
....................
13
7 1 0
2 10 0
10 13 0
9 1 0
8 16 0
16 16 0
2 7 0
2 16 0
6 4 0
19 7 0
18 18 0
10 2 0
6 2 0

6 1 0
14 7 0
19 4 0
16 13 0
11 19 0
16 16 0
3 1 0
19 0 0
12 19 0
3 11 0
8 13 0
14 19 0
3 4 0
