width 20
height 20
....................
................@...
.......@...........@
..@.................
.....@.........@....
.......@.....@....@.
..@.....@...........
...@........@.......
....................
........@...........
.@..............@...
....................
.@.....@.....@......
......@.............
.....@..@.@.....@...
....................
...@.............@..
.......@....@.@.....
@...................
....................
13
17 7 0
11 3 0
12 1 0
1 14 0
12 9 0
7 11 0
3 2 0
6 7 0
5 10 0
11 0 0
12 4 0
7 13 0
9 14 0

1 14 0
3 19 0
14 13 0
11 14 0
7 18 0
18 0 0
11 18 0
15 0 0
8 17 0
13 3 0
9 4 0
11 5 0
10 9 0
