width 20
height 20
@@@@@@@@@@@.........
@@@@@@@@............
@@@@@@@@@@@.....@...
@@@@@@@@@@....@....@
@@@@@@@@@@@@........
@@@@@@@@@@@.........
@@@@@@@@@@@.....@...
@@@@@@@@@@@.........
@@@@@@@@@......@..@.
@@@@@@@@......@.....
@@@@@@@@............
@@@@@@@@@.....@.@...
@@@@@@@@@..@........
@@@@@@@@............
..@.@@@@......@.@.@.
...........@........
.....@.@............
.@.......@....@.....
...@................
@...................
13
9 15 0
17 17 0
13 18 0
18 10 0
17 18 0
17 3 0
10 13 0
11 19 0
7 17 0
12 15 0
3 15 0
17 9 0
17 1 0

17 0 0
11 2 0
13 1 0
12 10 0
17 5 0
10 18 0
16 3 0
18 6 0
15 14 0
8 14 0
3 17 0
1 15 0
18 3 0
