width 20
height 20
@.@..............@.@
@....@....@.@.@.....
....@..............@
...................@
.....@........@....@
...................@
...@....@......@.@..
.....@..............
....................
.@...@..@....@.@....
..................@.
.............@......
......@.............
.........@...@.@..@.
............@....@..
..........@.........
.@..@...............
........@...........
..............@..@..
........@........@.@
13
9 10 0
1 15 0
0 18 0
5 12 0
15 15 0
5 3 0
17 1 0
18 5 0
11 8 0
13 15 0
14 10 0
4 12 0
14 0 0

19 1 0
1 15 0
2 17 0
15 0 0
1 0 0
1 2 0
0 19 0
4 5 0
11 1 0
1 1 0
17 7 0
18 4 0
16 12 0
