width 20
height 20
@.....@@@@@@@@@.....
@....@@@@@@@@@......
@....@@@@@@@@@.@....
@..@.@@@@..@@.....@.
@....@@@............
...............@....
...................@
.........@..@....@..
....@..@............
..........@....@@@@.
................@...
....@...@...........
...............@....
....................
.....@...........@..
....@...............
..........@......@..
.....@.........@....
@...................
@@@.................
13
1 5 0
15 14 0
17 17 0
2 11 0
6 5 0
5 10 0
19 1 0
17 8 0
8 4 0
19 10 0
19 11 0
17 5 0
7 16 0

14 19 0
10 8 0
16 18 0
18 0 0
18 15 0
16 19 0
7 11 0
15 18 0
18 17 0
7 7 0
2 8 0
15 14 0
16 0 0
