width 20
height 20
..@.................
.............@..@...
...@...@...@...@....
.....@.........@@...
...........@........
.....@..............
..........@.........
......@.............
..........@......@..
.@.....@............
...@...............@
....@....@..........
@...............@.@.
..............@.....
........@..@........
.....@.....@........
...............@....
....................
.........@......@.@.
................@@..
13
10 7 0
6 13 0
13 16 0
15 9 0
3 8 0
8 18 0
2 19 0
6 19 0
13 8 0
4 19 0
14 16 0
17 18 0
0 19 0

4 19 0
19 6 0
5 1 0
7 0 0
19 2 0
6 6 0
2 19 0
3 7 0
3 19 0
6 1 0
5 6 0
0 13 0
14 8 0
