width 20
height 20
@@..........@@@@@@@@
@......@......@@@@@@
@...........@.@..@@@
..@..........@...@@@
.....@..@....@...@@@
.................@@@
.@..................
..@........@..@.....
....@...............
..............@.....
......@...@....@....
.......@............
.@.....@............
.@...@.@............
....................
...@....@....@.@....
....................
...........@........
.......@.........@..
...............@@@..
13
1 10 0
11 13 0
16 5 0
11 6 0
4 6 0
16 8 0
15 16 0
9 12 0
6 14 0
4 0 0
7 7 0
14 6 0
4 1 0

11 10 0
12 10 0
18 9 0
12 5 0
10 1 0
18 15 0
17 17 0
18 10 0
6 16 0
6 4 0
19 18 0
10 2 0
7 0 0
