width 20
height 20
.......@@...........
................@...
@...................
.......@..@.........
..@........@...@....
......@.............
........@........@..
.............@.....@
.@..............@..@
...................@
...................@
.@......@....@.@...@
@@............@.....
........@...........
.........@.@..@.....
..........@..@.....@
..@...............@@
....@...@.........@@
..................@@
...................@
13
17 10 0
2 11 0
5 8 0
3 18 0
0 0 0
4 7 0
12 7 0
15 16 0
4 10 0
18 8 0
2 3 0
19 6 0
0 10 0

17 10 0
11 6 0
14 5 0
18 2 0
0 4 0
18 19 0
8 9 0
2 8 0
1 18 0
0 14 0
13 14 0
5 17 0
0 7 0
