width 20
height 20
.................@@@
.........@.......@@@
.@.....@............
....................
..@....@.....@......
......@.............
.......@.........@..
..........@.........
....@...............
.........@.......@..
....@...............
............@...@...
.........@....@.....
....................
...@..@.@...........
....@..@............
............@.......
................@..@
....................
....@@.......@@.....
13
3 3 0
7 14 0
9 15 0
18 7 0
4 12 0
9 2 0
0 19 0
18 6 0
9 11 0
14 4 0
19 9 0
1 15 0
15 19 0

9 15 0
5 4 0
18 2 0
7 19 0
9 2 0
16 5 0
2 19 0
9 10 0
4 16 0
0 14 0
1 19 0
18 17 0
0 6 0
