width 20
height 20
...............@@@@@
...............@@@@@
.......@......@@@@@@
....@..@.......@@@@@
.@.........@..@@@@@@
......@..@....@@@@@@
..@....@............
@..@..........@.@...
@....@......@.......
........@...........
@.....@........@.@..
@@.@@@@.............
@@..@@@.............
@...@@...@..........
@...................
@..........@.....@..
.........@..........
........@...........
...........@........
.............@......
13
11 16 0
9 9 0
18 19 0
17 14 0
10 19 0
13 17 0
0 2 0
13 3 0
8 12 0
2 14 0
3 1 0
5 10 0
16 12 0

8 7 0
7 8 0
10 6 0
18 6 0
5 0 0
18 15 0
10 16 0
1 19 0
15 12 0
2 16 0
5 6 0
19 12 0
18 13 0
