width 20
height 20
@@@..@.@.@@@@@@@@@..
@@.@.......@@@@@@..@
@....@.@.@@@@@@@.@..
..@.@..@@@@@@@@@...@
@.@@@@@@@@@@@@@.@.@@
...@@@.@@.@.@.@....@
@.@.@...........@.@@
......@.@.@.@.@..@@@
@.@@.@.@.@.@.@@.@@@@
@...@..@.....@.@@@@@
@.@.@.@.@.@@...@@@@@
.@..@...@.@..@..@.@@
..@..@@..@..@.@@...@
.@@.@@..@.@...@.@.@.
....@..@....@.......
.@.@.@...@.@..@.@.@.
.@....@.@@@.@..@@..@
@..@.@.@.@@...@...@.
@@@..@......@.@@@...
@@@@...@.@.@@@....@.
7
19 2 0
8 19 0
10 19 0
8 1 0
5 19 0
12 8 0
15 14 0

6 11 0
14 16 0
7 10 0
3 3 0
0 7 0
3 13 0
1 14 0
