width 20
height 20
.@@...@@.@@@..@...@@
.@..@@@...@.@...@..@
..@.@@@@@....@.@@.@@
.@@..@.@..@.@.@....@
....@@..@.@....@@.@.
@.@....@..@.@.@.@...
@@..@.@@.@@@@...@.@.
@.@..@@..@@@..@....@
..@.@.@.@.@@@.@.@@@@
@............@.@.@.@
..@.@.@.@.@.@.......
@..@..@@..@@@@.@@.@.
..@.@..@@..@..@@@@..
@....@@...@.@.@@.@@.
..@.@@@.@...........
.@...@@@.@.@.@.@@.@.
.@@.@.@.....@@...@..
.@..@.@@.@.@.@@.@.@.
.@.@@.@@@@@........@
@......@@@@@.@@.@@..
7
2 9 0
18 7 0
9 4 0
8 15 0
8 0 0
5 10 0
10 15 0

15 0 0
14 16 0
9 3 0
5 16 0
14 6 0
13 0 0
16 7 0
