width 20
height 20
..@@@@@@..@.@...@...
@.@@@@@..@...@.@.@.@
..@@@@.@.@.@........
@.@@@.....@@.@@.@.@@
......@.@..@...@@...
@@.@@..@.@.@.@@.@.@.
...@..@@.........@..
@.@@@..@@.@.@.@.@@@@
@..@..@@...@..@..@@.
..@@@...@.@@@.@.@...
@...@.@@@@.@@@@.@.@.
.@.@@@@@@@..@.@....@
.....@@@...@..@@.@@.
@@.@....@.@@@.@.....
..@..@@...@.....@.@@
@.@@.@..@..@@@@..@@.
....@@.@..@@....@.@.
@.@@@.@@@@@.@.@...@.
.......@@.@...@.@...
@@.@.@......@.@..@.@
7
15 7 0
13 12 0
19 10 0
17 16 0
5 17 0
7 19 0
1 8 0

14 2 0
15 8 0
6 15 0
7 14 0
15 17 0
14 4 0
12 2 0
