width 20
height 20
@@.@@.@@@@@@.@@@.@.@
........@@@...@.....
@.@.@.@.@@.@.@@@@.@.
...@.@@.........@.@@
@.@..@@@.@.@.@.@....
.@@@.@@.@...@...@.@@
..@..@@..@.@.@.@....
@..@....@.@.....@.@@
..@..@.@..@@.@@.....
@.@.@.@@.@..@...@.@.
@.@........@.@.@@@@@
....@.@.@@......@@.@
@.@..@.@@@@.@.@.....
...@@..@.@..@..@.@.@
@.@@..@....@.@@.@@@@
..@.@.@@@@......@@.@
@...@.@.@.@.@.@.....
..@.......@@...@.@.@
@@..@.@@.@.@.@@.@...
@@@..@......@.....@.
7
16 6 0
13 16 0
12 11 0
1 1 0
10 6 0
9 17 0
11 15 0

2 18 0
7 19 0
5 15 0
6 1 0
1 3 0
12 10 0
11 7 0
