width 20
height 20
@.@.@.@@@@@@@.@....@
......@.@..@...@@@..
@.@@@.....@@@.@....@
@.@@..@.@@.@...@.@..
.@.@.@.@.@..@@....@.
...........@...@.@@.
.@@.@.@.@.@@@.@@@...
..@..@..@@@@@@.@.@@.
.@.@@@.@.@@@.@......
....@.@........@@@@@
@.@.....@.@.@@...@.@
..@.@.@.@..@.@.@@...
.@.@@..@.@@......@.@
@....@@@.@.@.@.@...@
..@.@.........@@@.@@
.@....@@.@@.@@@@....
..@.@.@@@@@@..@.@@.@
.@.@.@@@@@@@.@@.....
......@@@@@..@@@.@.@
.@.@.@@@@@@@......@@
7
5 0 0
0 5 0
3 5 0
4 13 0
16 15 0
0 12 0
0 15 0

13 14 0
8 8 0
4 10 0
1 3 0
6 7 0
16 10 0
10 13 0
