width 20
height 20
@.@.@@@@@@@@@@@@@@..
.....@@@@@@@@@@@@@@.
@.@.@@@@@@@@@@@@@@..
.@..@@@@@@@@@@@@@@@.
..@..@@@@@@@@@@@@@@.
@...@.@@@@@@@@@@@@..
..@....@@@@@@@@@@@@.
.@@@.@..@@@@@@@@@@..
.@@@@..@.@.@@@@@@.@.
@@@@@@......@@@@....
@@@@...@@@.@.@@.@.@.
.@@@@.@.@@@.....@.@.
..@@@.....@@@.@....@
.@@...@@.@@@@@..@.@@
....@...@@.@@@@..@@@
@@@..@.@@...@@..@@@@
....@.@@.@.@.@.@@@@@
@.@........@....@@@@
...@.@.@.@...@.@@@@@
@@@@@..@@@@.@@@@@@@@
7
0 11 0
6 19 0
5 11 0
14 18 0
1 2 0
3 15 0
15 13 0

10 16 0
18 2 0
19 2 0
12 18 0
7 14 0
16 12 0
5 8 0
