width 20
height 20
@@@@.@@.@..@.@@.@@@@
@@@..@...@....@..@@@
@@@.@.@.@.@@.@..@@@@
@..............@@@@@
.@.@.@.@.@@.@@..@@@@
.@..@@@....@.@.@.@.@
.@.@.@.@.@@....@....
........@@@@.@...@@.
@@.@.@@@.@@.@@@.@...
.@@..@.@.....@.@.@.@
...@@....@.@........
.@...@.@.@@..@.@.@.@
@.@@...@.@@.@.@@@..@
....@.@@.@..@..@@@..
.@.@@@....@@@.@.@.@.
..@.@.@@.@..........
@.........@@.@@@.@@.
..@.@@.@.@@@..@@@@..
@@@@....@.@@.@@@@@@.
@@@@@@.@@....@@@@@@@
7
14 11 0
8 13 0
12 10 0
19 14 0
2 7 0
18 11 0
3 3 0

6 6 0
13 1 0
17 12 0
2 5 0
9 19 0
3 3 0
5 18 0
