width 20
height 20
@.@@@.@.@.....@.....
...@......@.@.@.@.@.
@.@@.@@.@@@.@@@@.@..
.......@@@.@.@.....@
@.@.@.@@@......@.@..
..@@.@@.@@.@@.@..@.@
@..@.........@@@@...
..@@.@.@.@.@.@.@.@.@
.@.@..@...@@@@.....@
.....@.@.@@@@@.@.@@.
.@.@.@..@@@@@.@.@@..
..@.@@.@.@.@.......@
.@..........@.@.@@..
.@@.@@.@.@.@@..@...@
...@@@.@..@.@@@.@@.@
@@..@.@..@..........
...@@..@...@@@.@@@.@
.@.@.@.@@@.@.@...@..
.@@@..........@.@.@.
.....@.@.@@@.@....@.
7
7 12 0
15 18 0
0 18 0
7 1 0
5 6 0
4 5 0
7 6 0

10 16 0
0 9 0
16 5 0
5 15 0
6 7 0
13 10 0
17 19 0
