width 20
height 20
@.@@.@.@@...@@@@@@@@
..........@@@@@@@.@@
@.@.@@@.@.@.@@@@..@@
@@.....@.....@.@.@.@
@@@.@.@@@.@.@@......
@@@@...@...@@@@@.@.@
@.@.@.@..@....@..@..
.......@.@.@.@..@.@.
.@.@.@..@@@@.@@@....
.@@@@.@@.@.@.@.@@.@.
...@............@..@
.@..@.@.@@.@.@.@@.@@
@..@...@....@.......
.@..@.@@@@.@@@.@.@.@
...@.@@@@@@@@@@..@@@
.@.@.@@@@@@@@@@@@@@@
.@...@@@@@@@@@@@@@@@
@@@.@@@@@@@@@@@@@@@@
@....@@@@@@@@@@@@@@@
@.@.@@@@@@@@@@@@@@@@
7
18 12 0
16 2 0
2 13 0
9 2 0
1 6 0
18 5 0
15 14 0

8 12 0
6 10 0
16 3 0
8 6 0
12 10 0
7 8 0
1 19 0
