width 20
height 20
@@@@@@@@.@....@@.@@@
@@@@@@@...@@@.....@@
@@@@.@.@.@.@.@.@.@@@
.@@......@......@@@@
.@.@.@.@@..@@.@@@@@@
.....@.@..@@..@@@@@@
@@@.@...@.@@@.@@@@@@
@@..@.@....@..@.@@@@
@@@.@@..@.@@@....@@@
@@@@...@..@@@.@.@@@@
@@@@@.@.@@@@.@.@@@@@
@@@@......@.....@@@@
@@@@@.@.@...@.@@@@@@
@@....@@@.@..@@@@@@@
@@.@@...@@@.@@@@@@@@
.....@.@.....@@@@@@@
.@.@.@.@.@.@.@@@@@@@
..@..@@.@@..@@@@@@@@
@..@......@@@@@@@@@@
@.@@@.@.@..@@@@@@@@@
7
9 7 0
13 7 0
2 16 0
8 18 0
16 1 0
13 11 0
0 3 0

14 3 0
12 11 0
9 1 0
16 8 0
8 3 0
6 16 0
1 17 0
