width 20
height 20
............@.@.@.@@
@.@@@@@@.@@.........
...@.@..@..@.@.@.@.@
@.@....@.@....@...@@
@.@@.@.....@.@.@.@@@
.@.@..@.@.@.....@@@@
...@.@@..@.@.@@@@@@@
.@....@@@@...@...@@@
@@.@.@@....@..@@..@@
..@.@...@@..@@.@.@@@
.@..@@@@...@@.....@@
..@..@.@.@...@@@.@.@
.@@.@..@@@@.@.......
......@.......@.@@.@
@.@.@.@@.@@.@@@@@...
@.@.@......@@.@..@@.
...@.@.@.@@@..@.@...
.@.@.@.@@@.@@.....@.
@@@@.......@@@.@@@@.
@@@..@.@@.@@@@@@@@..
7
15 13 0
3 13 0
7 5 0
3 3 0
4 0 0
15 1 0
18 13 0

10 17 0
5 18 0
8 14 0
10 13 0
12 13 0
18 11 0
17 0 0
