width 20
height 20
@..@@..@.@.@@@@@@@.@
@.@..@.@.....@@@@...
..@@.....@.@.@.@.@.@
@..@.@.@..@@@.......
..@@..@..@.@@@.@.@.@
@.@@.@.@.@.@@@@...@@
........@....@.@.@.@
.@.@.@.@.@.@........
..@.@......@@@.@.@@@
.@...@@@.@.@@@@.@.@@
..@.@@..@.@.@@@.@.@@
@...@.@.@....@.....@
..@.......@.@..@.@@@
@.@@.@.@@..@..@..@.@
@@..@@@...@.@..@....
@.@.....@....@@@.@.@
....@.@..@.@.@@.@...
@@@..@.@@@@......@.@
@@.@......@@@@.@....
@....@.@.@.....@.@.@
7
7 14 0
8 14 0
5 12 0
6 7 0
1 8 0
1 4 0
18 14 0

14 7 0
17 5 0
19 1 0
6 13 0
14 12 0
19 3 0
17 1 0
