width 20
height 20
@@@@@@@@@@@@@@......
@..@@@@@@@@@@..@.@.@
..@.@.@.@@.@@@..@@@@
@............@.@.@.@
..@.@@.@.@.@........
.@.@@@@@.@@..@.@.@.@
...@@@.@@.@@@.@..@@@
@@........@....@@..@
@.@.@.@.@...@.@@@@..
.....@..@@.@..@@@..@
@.@.@@@.@@@.@.@@.@.@
...@@@@@@@..........
.@.@@@@@@.@.@.@.@.@@
..@.@.@@.....@.@.@..
.@@......@.@@.....@.
.@..@.@.@@.@@.@@@...
@..@.@@@@.@@.@@@@.@.
.@...@.@......@..@@.
...@...@@.@.@.@.@...
.@..@@....@.@.....@.
7
19 4 0
1 11 0
8 17 0
14 2 0
4 18 0
9 16 0
19 0 0

19 18 0
1 4 0
19 0 0
2 7 0
5 8 0
10 9 0
11 17 0
