width 20
height 20
...@.@@.@@.@@@@..@.@
@@.@.@..@...@..@.@..
.....@@...@@@@.....@
@.@@...@@.@@@..@.@.@
....@@.....@.@.@@.@.
@.@@..@@@@@@...@....
@.@@@.@.@....@...@.@
...@@....@.@..@.@@.@
.@...@@@.@@..@@@...@
..@.@@.@..@.@@...@.@
.@.@.@.@.@.@@.@.@@..
.................@@.
.@.@.@.@.@@.@.@.@@@@
.@@@@.@....@...@@@@@
.@.@@.@.@.@@@.@.@@@@
.......@...@......@.
.@@@.@@.@.@@@.@.@...
.@@..@.....@@..@..@@
...@..@.@.@@@.@.@...
.@..@.@@@@@@@@....@@
7
9 1 0
13 5 0
18 8 0
4 0 0
10 6 0
1 2 0
4 3 0

0 9 0
14 1 0
1 15 0
19 4 0
4 18 0
7 13 0
16 6 0
