width 20
height 20
@.@.@.@@....@.@@.@.@
@......@.@.@..@.....
@@.@@.@.@...@...@.@.
.@@.......@@..@..@@.
...@@.@.@....@..@@@.
.@....@@.@.@.@@@....
.@@.@....@@@@.@.@@.@
...@@@@@...@....@...
.@@@@.@@@.@.@.@.@@.@
@@@@@..@.@..@@@.....
@@.@..@...@.....@.@.
@....@..@...@.@.@@..
.@.@...@..@.@@.@.@.@
....@.@@@.@@.@.@..@@
@@.@.@@@........@..@
@@...@@..@@.@.@@.@.@
...@@.@.@@@@........
.@.@....@@@@@@@@.@@.
.@@@@.@.@@@@..@.@...
...@...@@@@@@.....@.
7
18 5 0
13 7 0
4 14 0
11 2 0
13 2 0
2 19 0
6 19 0

18 5 0
8 12 0
18 11 0
16 17 0
5 6 0
1 16 0
4 15 0
