width 20
height 20
...........@@@@@@@@@
@.@.@.@.@@..@@@@@@@@
.@@@...@@..@@@@@@@@@
..@@@.@@@@..@@@@@@@@
.@.@@.@@@..@@@@@@@@@
...@.@.@.@..@@@@@@@@
@@........@.....@@@@
.@.@.@.@.@@@.@.@@.@@
....@...@@@..@..@.@@
.@.@.@.@.@.@.@.@..@@
.@.@.........@@@@..@
..@@.@.@@.@.@@.@@@..
.@..@.@...@@...@.@.@
...@@..@.@...@......
@@.@.@.@@.@.@..@.@.@
...........@..@.@.@@
@.@@.@.@@@.@@......@
....@....@.@.@.@@.@.
@.@.@@.@@......@....
@@...@...@.@.@..@.@.
7
16 16 0
15 6 0
1 3 0
12 6 0
11 10 0
7 10 0
0 3 0

11 18 0
13 6 0
5 10 0
14 13 0
19 11 0
5 2 0
14 19 0
