width 20
height 20
.@@@..@@@@.@.....@@@
..@.@..@@....@@@@@@@
.@....@@.@@@.@.@.@.@
.@.@@@.@............
.........@.@.@@@.@.@
.@.@.@.@..@.@@@...@@
..@...@@@...@@.@.@.@
.@@@.@.@.@@@.@...@.@
.@@@@@.....@...@....
@.@@.@.@.@.@.@@.@.@.
@.......@..@.@...@@@
..@@.@.@.@...@@.@@@.
@..@..@@.@.@......@.
..@.@@.@..@@.@.@@...
@.......@.@.@@@..@.@
..@.@@.@..@..@@@...@
@..@@...@..@..@@.@.@
..@...@.@@...@.@..@.
@.@@.@..@@.@.@...@@.
..@...@...@....@....
7
16 12 0
17 19 0
8 12 0
10 12 0
8 9 0
17 9 0
18 8 0

17 13 0
6 18 0
1 19 0
16 12 0
12 3 0
9 15 0
8 4 0
