width 20
height 20
@@@@@..@.@.@.@.@@...
@@@@.@.........@.@.@
@@@@...@@@.@.@.@....
@@@@.@@.@.@@@....@.@
@@@........@.@.@@...
@@@@.@@.@.@@..@@@@.@
@@@@..@.@...@.@@@@@.
@@@@.@...@.@........
@@@@@..@@.@.@.@@.@@.
@@.@.@.@......@.@@@.
@........@.@.@...@..
..@@.@.@..@@.@@.@..@
@.@..@@@.@@.@@....@@
...@...@....@@@.@..@
@.@@@.@..@@.@@@@@.@@
.@.@...@@.....@@@@@@
.@.@@.@.@@.@@@@@@@@@
......@.....@@@@@@@@
@@.@.@.@.@.@@@@@@@@@
....@@....@@@@@@@@@@
7
10 15 0
4 13 0
19 2 0
10 7 0
0 17 0
9 6 0
10 2 0

10 13 0
4 13 0
11 8 0
5 13 0
14 10 0
4 10 0
15 10 0
