width 20
height 20
@@@@@@@.@.@@.@@.@.@.
@@@@@@..............
@@@.@@@@.@.@.@.@@.@.
@@@....@..@.@@@.@.@.
@@@.@.@@@........@..
@@...@..@.@.@.@.@.@.
@.@.@.@.@@@..@..@.@.
............@@.@....
@.@.@.@.@.@..@..@@@.
...@.@@@...@@..@..@@
@.@@.@@.@.@@.@...@@@
.........@@....@@.@@
@.@.@.@.@@@@.@..@.@@
...@.@@....@..@....@
.@.@.@@.@@..@@@@@.@@
@.@....@.@.@.@@@....
....@.@@.@....@@@@.@
@.@@.......@@@@@....
....@.@.@.@@.@@..@.@
@.@.@..@.......@.@..
7
7 18 0
11 5 0
4 13 0
16 13 0
6 5 0
14 19 0
9 19 0

0 18 0
11 8 0
2 5 0
15 12 0
17 13 0
0 11 0
7 11 0
