width 20
height 20
@@@@@@@@@@@@@@@@@@@@
@@@@@@@@@@@@@@@@@.@@
@@@@@@@@@@@@@@@@...@
@@@@@@@@@@@@@.@.@.@.
@@@@@@@@@@@@........
@@@@@@@@@@@.@.@@@.@.
@@@@@@@@@.@.....@@..
@@@@@@@@....@.@@@@.@
@@@@@@@.@.@..@...@.@
@@@@@@..@@..@.@.@...
@@@@@.@..@@...@...@.
@@@.....@.@@@..@@@.@
@@@.@.@.....@.@.@...
.@@@...@@@@.....@.@.
..@.@@..@...@@.@@..@
.@.....@@@.@.@....@.
...@.@...@....@.@...
@.@.@..@@.@@.@.@..@.
..@...@@@.@.....@@..
@.@@.@@@....@.@.@@@.
7
9 11 0
6 16 0
5 18 0
15 4 0
15 8 0
2 15 0
13 5 0

10 15 0
13 4 0
12 13 0
19 9 0
8 19 0
7 12 0
16 2 0
