width 20
height 20
...................@
..........@.@.......
....................
....@....@..........
...@..@.............
........@...@.......
..@.......@...@.....
....@..@............
................@...
@...................
@..........@@.....@.
@@...@.@.@.@@.......
@@..............@...
....@............@..
.@...@..............
...@....@..........@
.................@..
.@......@.@.........
..@...@.............
@@@@................
13
10 10 0
16 10 0
14 5 0
18 4 0
3 12 0
17 7 1
10 4 1
7 18 1
15 3 1
4 11 2
4 6 2
3 1 2
14 15 2

12 19 0
16 10 0
0 15 0
16 3 0
1 15 0
11 14 1
16 17 1
5 10 1
7 8 1
3 11 2
7 5 2
18 18 2
6 1 2
