width 20
height 20
...@@@....@@@.......
............@.......
..@@@...@........@..
......@....@........
..@.......@...@.....
....@....@.@........
....................
...........@........
............@.......
...@..@......@......
....................
....@@..........@.@.
........@...@.@.....
...@.............@..
........@@..........
.........@........@.
@..@...@.......@....
..........@.........
....................
@....@.......@......
13
12 6 0
2 17 0
1 14 0
14 0 0
6 14 0
14 9 1
7 4 1
19 19 1
4 16 1
11 13 2
8 7 2
14 7 2
7 8 2

4 19 0
1 3 0
2 5 0
19 11 0
15 1 0
0 17 1
19 19 1
0 7 1
17 1 1
19 1 2
7 6 2
8 13 2
2 17 2
