width 20
height 20
.@@...............@@
.........@..........
.............@.@....
....................
................@...
..@...@.@...........
..........@...@.....
.............@..@...
..........@.......@.
....@......@........
..@.................
.@..........@.......
..@..@..@...........
...........@.....@..
................@...
......@.............
.............@...@..
......@.............
...@...........@...@
@..............@@@@@
13
11 3 0
11 2 0
3 1 0
16 15 0
3 10 0
14 4 1
6 16 1
6 11 1
19 5 1
17 1 2
5 2 2
3 2 2
3 8 2

0 10 0
16 10 0
5 1 0
15 15 0
12 12 0
1 17 1
6 9 1
6 11 1
12 16 1
19 7 2
19 16 2
7 6 2
1 3 2
