width 20
height 20
.........@.........@
.............@......
.@.....@............
.............@..@..@
..@....@............
....................
...@.@...@......@..@
.@.................@
.....@...........@.@
...@...@...........@
....................
.....@.@..@.........
...@...........@..@.
....@.......@...@...
..............@.....
.@.....@............
............@..@....
@...................
.............@...@..
..@..............@..
13
9 15 0
4 8 0
5 17 0
12 3 0
7 14 0
16 18 1
19 18 1
14 2 1
17 11 1
13 9 2
10 14 2
10 12 2
0 1 2

18 9 0
13 6 0
18 1 0
9 11 0
12 7 0
12 8 1
18 4 1
2 5 1
0 2 1
18 7 2
12 9 2
5 18 2
9 2 2
