width 20
height 20
.................@@@
..........@.........
....@......@..@..@..
........@...........
.......@.@...@......
...@.@.............@
@...........@.......
@...........@......@
@........@..........
....@.@......@...@..
....................
..................@.
....@..@............
...@...@@.....@.....
..@.....@....@......
@...........@.......
....@.@...@....@....
@...................
@...................
@...................
13
18 13 0
6 13 0
19 17 0
5 10 0
6 3 0
11 11 1
5 8 1
14 1 1
13 19 1
18 9 2
16 5 2
5 3 2
10 8 2

4 7 0
4 18 0
6 4 0
0 3 0
12 13 0
0 0 1
19 19 1
7 19 1
19 8 1
15 4 2
9 3 2
8 15 2
12 12 2
