width 20
height 20
@........@..........
........@..@........
.@.@.@............@.
.......@...@........
....@.....@.......@.
............@.......
...@............@...
.........@..........
....@.@.@.@.........
...............@....
............@.......
....................
....................
...@.@..@...........
...................@
..............@....@
...@.......@........
.......@.......@....
....................
...............@@...
13
19 19 0
4 10 0
2 9 0
2 17 0
15 3 0
19 13 1
12 1 1
17 7 1
11 9 1
4 5 2
0 19 2
17 0 2
1 17 2

17 15 0
2 7 0
5 6 0
7 10 0
14 6 0
18 13 1
13 9 1
14 12 1
0 18 1
15 14 2
1 19 2
8 4 2
9 15 2
