width 20
height 20
...........@@.......
........@.@.........
...@..............@.
.@.@.......@........
......@..@..........
................@...
....@..@............
......@.@.@.........
..............@.....
.............@......
............@.......
....@...@...........
.......@.@..@.......
....................
.........@...@.@....
.....@..............
......@..@.@........
....@...............
................@...
...........@........
13
13 7 0
1 1 0
16 8 0
7 8 0
18 13 0
17 14 1
10 3 1
5 6 1
2 5 1
4 0 2
19 6 2
0 5 2
4 15 2

11 8 0
12 4 0
12 2 0
11 4 0
19 17 0
10 2 1
1 15 1
2 2 1
9 3 1
7 18 2
2 10 2
0 10 2
14 16 2
