width 20
height 20
@@@............@....
...........@........
.....@..............
.@.............@....
..........@.@.......
...@..@.............
....................
......@..@..@.@..@..
....@...............
@@..................
@@......@...........
@@.........@..@.....
@@........@......@@.
....@.@.............
.......@....@.......
....................
..@......@...@......
...@.@..@...@.@.@...
......@..........@..
....................
13
6 14 0
16 11 0
19 4 0
8 4 0
16 18 0
0 3 1
1 6 1
14 18 1
3 2 1
9 14 2
10 11 2
17 3 2
13 2 2

19 5 0
10 2 0
19 0 0
5 6 0
17 8 0
0 3 1
19 18 1
3 1 1
18 18 1
17 2 2
14 0 2
18 3 2
1 17 2
