width 20
height 20
@@@.................
@@.........@.....@..
................@...
...............@....
.............@......
..................@.
.........@.@........
..@......@...@......
........@...........
.................@..
.........@..........
.@.@.@............@.
.......@....@.@..@..
.............@...@@.
.........@..@.......
.....@.@.....@..@...
...............@.@..
....................
..@.................
....@........@@@....
13
15 1 0
11 16 0
7 11 0
9 16 0
10 0 0
17 3 1
2 9 1
16 9 1
13 5 1
10 14 2
0 16 2
3 15 2
11 0 2

3 19 0
10 3 0
8 10 0
11 18 0
10 4 0
3 12 1
8 17 1
15 10 1
14 2 1
10 14 2
13 17 2
4 7 2
19 1 2
