width 20
height 20
.............@@.....
....................
...@................
...........@..@.....
@@....@.............
..@..............@..
..@.....@...@@......
...@................
.......@.@..........
...@................
@............@..@...
@........@..........
@....@..............
@.....@..@.......@..
...@...@......@.....
................@...
@....@.@....@......@
........@.@....@....
......@......@......
@.@@@@@.........@@@.
13
2 10 0
8 5 0
2 7 0
11 0 0
13 19 0
11 6 1
10 0 1
0 18 1
12 2 1
12 1 2
8 16 2
9 4 2
19 13 2

5 6 0
8 5 0
11 15 0
14 17 0
11 0 0
0 17 1
6 1 1
17 7 1
1 5 1
5 4 2
19 18 2
12 19 2
5 17 2
