width 20
height 20
...............@.@..
....................
....@...............
.....@.............@
.@........@.........
............@.......
....@.........@.....
..@.............@...
@@@..@.@............
......@....@......@.
.............@.@....
..@.....@.@.....@...
.....@..............
..@....@............
...........@..@.@...
....................
....................
........@.@...@.....
....................
....@.@@...........@
13
7 17 0
1 7 0
10 18 0
14 13 0
4 13 0
14 18 1
16 10 1
13 4 1
8 13 1
1 18 2
5 18 2
15 14 2
4 12 2

9 12 0
15 16 0
4 17 0
16 1 0
15 8 0
0 2 1
16 9 1
12 4 1
19 6 1
6 1 2
5 18 2
0 1 2
11 11 2
