width 20
height 20
..........@..@.@@@..
........@...........
...@@..@....@.......
....@...............
....................
..@.......@.@...@.@.
......@.@.....@.....
.......@............
...........@........
..@.@...@...@..@....
....................
......@.......@.....
.....@.....@......@.
.@.............@...@
.........@..........
............@.......
...........@...@...@
..@...@...........@@
@............@...@@@
......@.@@.......@@@
13
17 15 0
14 16 0
16 6 0
5 13 0
0 8 0
0 17 1
1 12 1
19 9 1
11 0 1
11 5 2
17 1 2
8 11 2
19 10 2

15 17 0
15 18 0
3 13 0
11 11 0
14 12 0
3 10 1
1 11 1
15 4 1
11 1 1
0 19 2
17 1 2
0 7 2
5 18 2
