width 20
height 20
................@...
........@.......@...
......@..@.....@@...
....@.......@..@....
..@..............@..
......@.@....@......
............@.......
....................
.......@.........@..
........@...........
................@...
..@..@.@....@.......
...@.........@.@....
.......@.....@....@.
.........@..@.....@.
.@......@@..........
....................
............@.@.....
.....@.@.........@..
....................
13
10 5 0
11 16 0
14 15 0
14 5 0
11 5 0
5 4 1
1 18 1
2 5 1
15 4 1
6 15 2
7 2 2
8 14 2
15 19 2

0 19 0
10 5 0
15 9 0
4 17 0
8 13 0
5 10 1
1 17 1
17 10 1
19 18 1
6 14 2
7 3 2
7 14 2
6 16 2
