width 20
height 20
...........@@.......
@.@...@..@..........
.@.....@............
....................
....@........@......
...............@....
............@......@
..@....@........@..@
...................@
.....@....@......@@@
.....@............@@
....@@@.....@..@...@
.@.................@
...........@.@.@....
...@..............@.
@@@..@.....@........
@.........@....@....
....................
...@@...........@...
....@.......@.......
13
17 17 0
9 10 0
9 3 0
4 12 0
10 6 0
18 0 1
0 5 1
11 17 1
12 7 1
2 14 2
19 3 2
19 19 2
11 18 2

14 10 0
1 3 0
16 0 0
18 1 0
11 19 0
12 18 1
5 5 1
11 17 1
0 19 1
3 7 2
2 11 2
19 17 2
3 9 2
