width 20
height 20
........@...........
..........@.........
..@......@..........
.@..........@.......
...........@..@.....
....................
....................
...@.@..............
..@...........@..@..
.......@...@........
....@...............
..@....@............
....................
.........@...@...@..
...@......@@........
....................
....................
......@...@...@...@.
................@@@@
...............@@@@@
13
2 13 0
6 1 0
14 14 0
3 9 0
17 7 0
1 18 1
6 9 1
16 10 1
7 1 1
0 2 2
5 13 2
13 6 2
7 13 2

2 13 0
17 12 0
13 2 0
6 6 0
17 4 0
9 16 1
4 12 1
4 3 1
19 4 1
0 5 2
5 10 2
17 15 2
10 12 2
