width 20
height 20
........@@.........@
.....@.............@
.........@.@........
................@...
.@.@...........@....
......@.@...........
....................
......@.@...@.......
.......@.@......@...
...........@........
.....@..@...........
....@....@..........
..@.................
@..........@.@......
...................@
.......@..........@@
..@@.@...@..........
......@...@@@...@...
@.........@@@.......
@@..................
13
3 12 0
19 6 0
16 4 0
19 17 0
12 11 0
10 1 1
0 1 1
7 10 1
2 9 1
4 10 2
16 19 2
12 4 2
17 7 2

6 11 0
15 10 0
18 5 0
2 17 0
12 12 0
13 5 1
17 16 1
8 9 1
11 0 1
9 6 2
9 4 2
7 17 2
2 19 2
