width 20
height 20
@@@..............@@.
.........@.......@..
......@.............
........@..@.@..@...
...@.@..............
........@...........
..@...@....@.@..@...
.............@.@....
...@....@...........
.......@............
..........@.......@@
.@...............@..
...@................
.....@.....@...@....
.............@......
....@.....@.....@...
.........@..........
....................
.........@..........
...........@........
13
1 2 0
8 19 0
16 14 0
7 11 0
13 0 0
18 13 1
11 11 1
13 5 1
14 11 1
4 4 2
4 10 2
12 7 2
11 1 2

4 12 0
4 10 0
1 8 0
4 11 0
2 15 0
1 3 1
0 2 1
11 0 1
10 5 1
18 19 2
9 6 2
0 16 2
19 18 2
