width 20
height 20
............@@@....@
...................@
.....@...@........@@
.......@..........@@
......@....@.......@
...@@.......@.....@@
....@....@....@...@@
.@..............@...
....................
....@.......@.@.....
........@.......@...
............@.......
.....@.@..@....@....
.........@..........
.....@..............
....@...@....@.@....
......@.............
@...........@.......
....................
@..........@........
13
12 6 0
1 1 0
1 3 0
9 4 0
10 19 0
16 3 1
11 10 1
17 1 1
2 6 1
3 2 2
17 5 2
4 19 2
5 17 2

2 14 0
14 3 0
2 3 0
6 15 0
0 0 0
0 18 1
13 5 1
16 6 1
9 14 1
3 2 2
5 11 2
1 13 2
18 11 2
