width 20
height 20
...@@@@.......@.....
.....@..............
............@...@...
.@..................
....................
.....@..............
........@..@.@......
..........@....@...@
..@...@...........@.
.....@..............
.........@....@.....
...@........@.......
.........@..........
..@.............@...
....................
....................
....@..........@....
...@...@.....@....@.
...................@
@..................@
13
16 11 0
12 12 0
10 12 0
4 14 0
15 10 0
15 19 1
17 3 1
3 12 1
12 0 1
10 15 2
1 9 2
19 14 2
11 10 2

10 3 0
1 1 0
10 12 0
5 13 0
11 16 0
16 19 1
12 1 1
16 18 1
12 0 1
8 15 2
18 5 2
7 4 2
8 1 2
