width 20
height 20
....................
.........@..........
...............@....
....@.@.............
....................
.............@......
@.....@.@...........
@..@................
@..........@..@...@.
@......@.......@....
@.......@...........
..............@.....
..........@....@....
...........@........
@.....@.............
.............@.@....
....@.@..@...@....@.
.............@......
............@.......
..@@@.......@.......
13
7 19 0
16 4 0
12 15 0
11 5 0
11 0 0
11 7 1
7 7 1
11 12 1
16 19 1
18 4 2
2 15 2
12 12 2
11 6 2

6 11 0
9 18 0
17 1 0
10 9 0
8 1 0
0 0 1
17 15 1
13 11 1
16 18 1
8 2 2
2 13 2
18 1 2
7 5 2
