width 20
height 20
...................@
..........@........@
@..@...............@
.......@..@.@....@@@
@................@@@
@...@....@..........
@.@.........@...@..@
......@....@......@@
@...@..@.@........@@
..@...............@@
......@.......@...@@
....@.....@.......@@
........@@.@.@....@@
..............@...@.
......@.............
.@.....@............
......@.........@..@
..@......@..........
....................
....................
13
11 14 0
2 19 0
11 18 0
5 18 0
3 1 0
2 11 1
0 11 1
7 1 1
5 10 1
8 4 2
1 10 2
15 0 2
8 1 2

8 14 0
3 3 0
16 9 0
17 8 0
13 5 0
5 13 1
15 14 1
19 19 1
17 9 1
14 11 2
6 18 2
15 11 2
13 0 2
