width 20
height 20
....................
.......@............
@...@.@.............
@.........@.........
@...................
@.......@..........@
.......@..@@....@..@
.@............@....@
...................@
......@..........@..
..........@.........
....@..@....@.@.....
....@...............
........@...........
.................@..
..@........@........
...@..@.............
....@..@............
@............@......
@@@@................
8
9 14 0
3 4 0
6 15 0
14 12 1
14 15 1
9 6 1
15 14 2
14 10 2

19 0 0
16 0 0
14 15 0
14 10 1
13 7 1
3 11 1
2 18 2
13 11 2
