width 20
height 20
@@....@.............
@@..................
..@......@..........
.....@.@....@.......
....@...............
.......@....@..@....
..@.@@..@...........
....@.........@@@@@.
@............@.@@@..
...............@....
.@......@.@.@.......
....@......@.....@@@
...........@..@.....
......@.............
...............@....
@.@@@@..............
@@@@@......@...@..@.
@@@@@@@..........@..
@@@@@@..............
@@@@@@..............
8
14 6 0
10 2 0
13 10 0
10 13 1
15 4 1
18 5 1
5 10 2
11 6 2

5 16 0
10 4 0
19 13 0
10 17 1
14 3 1
0 14 1
12 2 2
11 4 2
