width 20
height 20
.@@@@@@@@@@@........
.@@@@@@@@@@.........
.@@.........@.......
...............@....
.........@.......@..
...@.........@......
......@.@.......@...
..@.................
......@..........@..
...................@
......@..@.@.......@
..............@.....
..@...............@@
@..........@.@....@.
@........@..........
@@@@.@......@....@..
@@@@................
@@@@.............@..
@@@@@.....@.........
@@@@@@.............@
8
14 4 0
8 18 0
7 16 0
5 8 1
5 6 1
0 0 1
4 9 2
10 5 2

4 17 0
17 0 0
17 14 0
19 18 1
7 2 1
15 16 1
7 3 2
10 6 2
