width 20
height 20
.....@......@.......
................@...
.....@..............
....@@@.............
@...........@.......
@.@.......@@........
..........@@........
............@.......
............@.@.@..@
@.......@..@@@.....@
......@............@
....@...........@...
.................@..
..@.........@@......
......@@..@.........
.......@.........@..
....................
...........@........
........@....@.@....
@...................
8
19 2 0
18 1 0
15 11 0
18 4 1
7 18 1
0 6 1
0 7 2
10 11 2

4 1 0
2 6 0
3 0 0
18 11 1
8 16 1
14 13 1
18 18 2
4 10 2
