width 20
height 20
@......@@@@@........
......@@..@...@.....
...........@..@.....
.............@...@..
....................
..@.@@@.............
.......@....@.......
.....@.......@......
.......@@@..........
....................
..@..@....@.......@.
....................
.@..@.......@.......
....@.........@.....
....................
...............@.@.@
......@.............
....................
...........@........
....@......@@@......
8
7 18 0
3 16 0
4 8 0
1 7 1
14 16 1
8 4 1
4 18 2
11 6 2

19 1 0
5 19 0
6 14 0
17 12 1
1 5 1
8 17 1
17 1 2
4 2 2
