width 20
height 20
@...................
@..@..@.....@.......
@.......@...........
..............@.....
...................@
.......@....@......@
....@...............
.....@....@....@....
.......@............
...................@
..@...............@@
.............@..@...
...@................
.@......@....@....@.
......@...@.@..@....
...@................
@...@....@..........
....................
.....@.............@
....................
8
2 13 0
14 9 0
15 3 0
15 13 1
12 2 1
2 17 1
2 16 2
16 2 2

8 0 0
14 18 0
16 9 0
14 7 1
5 9 1
1 5 1
11 1 2
16 10 2
