width 20
height 20
.....@@.............
.....@..............
...@.@....@.....@...
.........@....@@@...
..............@@....
.............@@@....
..............@.@...
....@....@......@@..
........@...........
..@...@..@..@..@....
.....@......@....@..
..........@.........
....@.@.@...........
....................
...........@..@.@...
............@......@
.....@..............
...@@...@.....@.....
@.@.@........@.@....
...................@
8
13 8 0
11 3 0
14 19 0
7 15 1
0 14 1
4 3 1
9 18 2
2 4 2

7 19 0
11 9 0
10 17 0
7 12 1
17 4 1
10 8 1
12 19 2
6 8 2
