width 20
height 20
....................
........@..@..@.....
@@..............@..@
@......@............
...........@........
....@........@..@...
..@......@..........
....................
..@@......@.........
........@..@........
.....@...........@..
.@........@.........
...@..@...........@@
...................@
..........@.@.@.....
.......@............
.....@...@..........
...@................
...............@....
....................
8
0 16 0
6 8 0
1 10 0
2 5 1
13 15 1
13 1 1
8 7 2
4 7 2

4 19 0
13 3 0
1 10 0
1 6 1
0 0 1
0 16 1
19 18 2
4 7 2
