width 20
height 20
@.........@.......@.
...............@@...
........@...@.......
..@.........@@......
.......@............
....@.....@..@......
......@..........@..
........@....@......
..............@.....
.....@....@....@.@..
.........@.........@
...@...@...@.@.@....
....................
.@........@..@...@..
.....@..@...........
....@.......@.......
...............@....
..............@...@@
....@.....@.........
...............@....
8
8 1 0
1 8 0
16 7 0
15 8 1
1 11 1
8 16 1
16 0 2
11 16 2

13 9 0
19 18 0
16 17 0
18 10 1
5 8 1
8 10 1
4 8 2
1 4 2
