width 20
height 20
@........@.........@
@.....@....@........
@@..................
@.............@.....
@...@@@@.....@......
..@@.@....@.........
...@................
......@....@........
@@...............@..
@@..................
......@@...@@....@..
...@.......@@...@...
.....@@...@@........
................@...
@..........@....@...
...........@@...@...
............@.@.....
...@.........@......
..................@.
............@.......
8
15 5 0
0 10 0
8 7 0
10 8 1
0 5 1
9 3 1
4 7 2
5 2 2

3 19 0
17 0 0
9 7 0
17 4 1
18 19 1
13 9 1
9 1 2
12 12 2
