width 20
height 20
@..................@
@...................
@.......@...@.......
@.........@.....@@..
....@.@......@..@...
..............@.....
.@.......@..........
........@.......@...
.....@.@.@..........
.............@....@.
.........@.@..@.....
......@.............
....................
...@.........@...@..
....@..@............
....................
.....@.....@@...@...
..........@...@.....
.........@..........
....................
8
8 11 0
2 8 0
17 11 0
12 12 1
10 1 1
6 15 1
15 12 2
7 10 2

4 17 0
18 18 0
5 19 0
2 18 1
3 2 1
6 15 1
7 10 2
12 9 2
