width 20
height 20
.....@@.............
..............@...@.
....................
...@.@....@.........
.@..................
..............@..@..
.....@..@...@.......
................@.@.
.@..................
..............@.....
....@..@..@@...@...@
.................@..
........@...........
....@......@........
...@.........@...@..
.......@............
......@.@.........@.
.............@..@...
....................
@@..................
8
10 6 0
10 13 0
15 2 0
2 9 1
9 9 1
13 1 1
5 1 2
5 10 2

18 0 0
11 15 0
2 5 0
15 15 1
18 18 1
16 3 1
16 12 2
11 16 2
