width 20
height 20
....@..............@
.....@..............
..............@.....
..@..@......@.......
..........@.........
.@......@.....@.@...
.......@@...........
.@......@...........
..@..........@......
...@.....@..........
.....@..@.......@...
..@...@........@....
.............@......
....@...@..@........
...............@...@
......@.............
....@....@..@.......
................@...
.....@......@...@...
@...............@@..
8
3 13 0
12 8 0
1 1 0
2 5 1
16 0 1
3 17 1
18 17 2
16 6 2

19 19 0
18 0 0
7 5 0
19 9 1
1 19 1
19 1 1
7 19 2
6 6 2
