width 20
height 20
@@@.................
@...@........@....@@
...@@...............
...........@........
..........@.@.......
...................@
....@..............@
.......@............
......@......@..@@..
................@@.@
@.@........@@@@@@@..
............@@@@..@.
....@.@.....@@@@....
.....@.......@@@..@.
....@........@@.....
..........@.........
...@.@...@......@...
....@...............
.@......@.....@.....
.......@............
8
11 15 0
3 1 0
0 16 0
18 19 1
6 13 1
0 7 1
18 2 2
1 2 2

0 17 0
1 3 0
7 18 0
12 7 1
6 15 1
5 6 1
18 3 2
12 15 2
