width 20
height 20
....................
.........@.@........
....................
.................@..
@..@@..@.@....@.....
.............@......
......@...@.........
...........@..@.....
.......@............
....................
.........@.@........
...............@....
....@..@..@......@..
........@...........
..@.............@...
.......@..@.........
....................
..................@@
.........@........@@
..................@@
8
12 7 0
17 5 0
1 15 0
1 13 1
5 15 1
8 3 1
7 3 2
19 6 2

17 9 0
0 19 0
10 2 0
5 19 1
15 1 1
13 4 1
5 1 2
2 1 2
