width 20
height 20
...@@.......@@..@...
.............@.....@
...@..@......@......
....@..@..@.@....@..
....................
....................
@............@@...@.
.........@...@......
.......@...@........
....................
..@.................
........@...........
....................
......@.......@.@...
............@.......
...........@.@......
.....@.........@....
................@...
........@...........
........@@@@@.@.....
8
6 1 0
2 7 0
10 16 0
2 3 1
14 16 1
15 8 1
2 13 2
19 7 2

14 18 0
2 6 0
14 0 0
19 19 1
10 17 1
7 11 1
4 7 2
11 12 2
