width 20
height 20
................@...
......@.............
.....@.@............
.@.............@.@..
....@...@.....@.....
....................
...@......@..@..@...
........@@........@.
......@.............
...@.........@......
.........@..........
.....@....@....@....
..............@...@.
...@@........@......
@@....@.@.......@...
@@.....@.@..........
....................
....................
@..@...@..@..@......
@...................
8
10 13 0
6 0 0
9 1 0
14 8 1
4 19 1
5 3 1
2 10 2
15 2 2

11 9 0
18 19 0
8 1 0
17 7 1
19 0 1
15 19 1
15 7 2
17 19 2
