width 20
height 20
....................
.@....@......@.....@
.......@............
..@........@...@....
..................@.
..@.................
..........@.@..@....
....................
..@....@............
.@....@.@...........
.........@..@.......
....@............@..
..................@.
..............@.....
....@.@......@......
....................
.@.......@..........
.....@..............
....@.......@.@.....
....................
8
11 0 0
13 9 0
15 13 0
0 18 1
14 9 1
11 4 1
11 13 2
12 3 2

1 18 0
1 17 0
9 4 0
16 0 1
18 19 1
0 16 1
4 3 2
2 15 2
