width 20
height 20
...@.@........@@....
...@...@............
..........@.........
....................
..........@...@...@@
@...................
........@...........
.......@....@....@..
.........@....@.....
...............@....
.........@..........
..@.................
..........@..@..@...
......@.............
....................
....................
...@.......@...@.@..
........@..........@
...................@
@@..................
8
11 2 0
1 2 0
5 15 0
1 9 1
1 10 1
11 19 1
7 16 2
1 12 2

4 14 0
9 9 0
5 8 0
4 10 1
8 16 1
19 5 1
11 5 2
19 0 2
