width 20
height 20
..............@.....
....................
...@................
.@.......@....@.....
....................
...@.............@..
....@....@......@...
@....@.......@......
....................
........@.......@...
..........@.........
..@......@.......@..
.@..........@..@.@@@
.................@@@
....@.@....@...@.@@@
.................@@@
..@................@
...................@
.......@............
@@............@.....
8
1 8 0
9 5 0
4 13 0
10 11 1
15 7 1
0 18 1
8 3 2
15 1 2

1 2 0
8 4 0
19 1 0
15 0 1
14 9 1
2 4 1
7 2 2
14 2 2
