width 20
height 20
@@@.@.@@.@.@.@...@@@
.@.............@.@..
...@.@.@.@.@@.@@..@.
@@..@..@@...@.@.@...
@..@@@...@@@@@@...@.
.@..@..@@.@.@.@.@..@
...@@@..@........@@@
.@.@@@.@..@.@.@.@@@@
..@@@@@..@@@.@@...@.
.@@@.@.@..@@.@..@.@.
@.@......@.@..@..@..
...@.@@.@...@...@..@
@.@@@@@..@.@..@.@@..
...@.@.@.@..@..@@..@
@.@@....@@.@..@@.@..
.....@@@...@@......@
@.@.@..@.@@@@.@@.@@@
...@@@.@.@.@....@@@@
.@@.@........@.@@@@@
......@.@.@@..@@@@@@
4
8 16 0
1 17 0
0 5 1
10 11 2

8 1 0
1 17 0
0 13 1
5 1 2
