width 20
height 20
@.@.@..@@@@.....@...
......@.@@@@@.@...@.
@.@.@....@@@@@..@.@.
@..@@.@.@.@@@..@.@.@
.@@..@..@.@@.@......
.@.@.@@....@..@@@.@@
.@......@.@..@.....@
...@.@.@.@.@..@@@.@.
.@..@@.......@......
.@@@@..@.@.@@@@.@@@.
@@..@.@.@.@.@....@..
...@........@@@.@.@@
@@..@.@.@.@.........
.@.@..@@.@.@@@.@@@@.
....@......@..@.@.@.
.@@.@@@.@@@.@.@.....
.@.@.@.@@.@.....@.@.
..........@.@@.@@@..
@.@.@.@.@....@....@.
..@@@..@..@.@..@.@..
4
19 4 0
19 19 0
4 5 1
8 13 2

8 13 0
12 18 0
17 12 1
1 14 2
