width 20
height 20
@@@..@...@.@@@@@....
@@@@..@.@...@@@..@@@
@@@..@@...@..@..@@@@
@@@@....@.@.@.@.@@.@
@.@.@.@@...@....@...
......@.@.@.@.@@.@.@
.@.@.@..............
@@..@.@.@@.@.@.@.@.@
...@@.....@.@@@...@.
@@.@..@@.@@..@@@@...
@@@.@.@.@.@@..@...@.
@@@.@........@@@.@@.
.@....@@.@@.@@.@@...
..@.@..@.@@.@.....@.
.@@..@@..@.@.@@.@..@
.@..@@.@@..@....@.@@
.@.@@..@@@...@.@....
...@@@..@..@.@@.@.@.
@.@@@@.@.@..@@@....@
@@@@@......@@@..@.@@
4
14 6 0
16 18 0
18 16 1
11 6 2

1 5 0
17 14 0
9 19 1
9 6 2
