width 20
height 20
@@@@.@@@@.@@@@@@@@@@
@@@..@@....@@@@@@@@@
@@@@.@@@.@..@..@.@@@
@@@...@..@.@.@....@@
@@.@.@.@@.....@@.@@@
@.........@.@....@.@
@@.@.@.@@@.@.@.@....
....@.@@@@....@@.@.@
@@.@...@...@.@@.@.@@
.@.@.@..@.@@......@@
......@@....@@@.@.@.
.@@@.@@.@.@.@..@@.@.
...@@.@.@..@..@@@...
.@@@@.....@..@.@.@@.
.@.@..@.@...@.......
.....@.@@@@@.@@.@.@.
@.@@.@..@..@..@@.@@@
....@@.@.@...@@..@.@
@.@........@@@.@....
@@..@@.@.@.......@.@
4
17 6 0
4 16 0
4 10 1
9 5 2

7 1 0
18 12 0
19 15 1
0 7 2
