width 20
height 20
@@@@@.@.@.@@@@..@@@@
@@@@@........@.@@@@@
.@@@..@.@.@.@...@@@@
.@@..@...@@...@@@.@.
..@@..@.@.@.@.@@@.@.
.@..@@....@@.@.@....
...@..@.@.......@.@.
@.@.@..@@@.@.@@..@@.
....@.@.@@@.@..@....
@@@......@...@..@.@@
@.@@@.@@...@@..@....
@.....@..@.@@@...@@.
@.@.@@.@@.....@@.@.@
@@.....@..@.@.......
@@@.@.@.@.@.@.@.@.@.
@@@@.....@.@.@...@..
.@@.@.@.@......@.@@.
.....@...@.@.@@.@@@.
@.@@..@.@@@......@@@
....@....@..@.@.@@@@
4
2 11 0
4 15 0
3 14 1
16 18 2

7 1 0
7 4 0
0 16 1
14 13 2
