width 20
height 20
@@@@@@.@........@.@@
@@@@@....@.@.@.@..@@
@@@@@@.@@.@@@@@.@...
@@@........@.@....@@
@@@@.@.@.@....@.@..@
@@@@.@@.@@@.@....@@.
@.@@......@@..@.@@..
...@@.@.@@...@..@.@.
@.@.@.@.@@@.@.@.@.@.
....@@.@.@.@@.......
.@@.@......@..@.@.@.
@.@.@@.@.@.@.@@@.@..
........@....@@@.@@.
.@.@.@.@@@.@@..@.@@.
@...@.@@@.@.@.@.....
.@.@@.@@....@.@@.@@.
...@@...@.@......@.@
.@....@@...@.@.@....
@..@@.@.@.@.@..@.@@.
@@@@@@......@.@@@...
4
14 1 0
2 16 0
12 16 1
13 19 2

4 5 0
5 17 0
16 5 1
16 16 2
