width 20
height 20
@@@...........@.@..@
@@.@.@@.@.@.@....@.@
.....@...@.@..@@....
.@@.@.@.@....@@@.@.@
@...@....@.@@.@.@...
@@@..@@.@.@......@.@
@@.@.@....@@.@.@....
@...@@@.@.@@.@@@@@.@
.@@..@...@.@@..@@@@@
.@..@..@....@.@@@@@@
.@@...@..@@....@@.@@
..@@@..@...@.@....@@
.@...@@.@@@@..@.@.@@
.@.@.........@.@@@@@
..@..@@.@@.@...@@@@@
.@.@..@@.@@@@.@@@@@@
.....@.....@.@@@@@@@
@.@@...@.@....@@@@@@
@...@.@.@.@.@.@@@@@@
@@@@@@......@.@@@@@@
4
12 2 0
5 11 0
6 16 1
11 13 2

5 4 0
6 8 0
6 2 1
15 11 2
