width 20
height 20
@@@@@@@@@@@@@@@@.@@@
@@.@@@@@@@@@@@@...@.
.@..@@@.@@@@@@.@@...
...@.@...@.@.....@.@
.@....@.@..@@@.@.@..
..@@.@....@@@@..@@.@
@@@....@@.....@.....
@...@.@...@.@.@.@@.@
@.@@@.@@.@.@.@.@...@
@@.@.@@.........@.@.
@.......@.@.@.@.....
..@.@.@..@.@..@@@.@.
@..@...@@@.@.@@@@@..
@@.@@.@@@...@.@@@.@@
@@@@@..@..@....@....
@@@@.@...@@.@.@.@@.@
@@@....@.@.@........
@@.@.@.@@...@@.@@@.@
@..@.@@..@@.......@@
@@......@@@@.@.@.@@@
4
15 6 0
11 13 0
19 9 1
7 9 2

4 19 0
11 17 0
11 14 1
4 16 2
