width 20
height 20
@@@@@.@.@.@..@@.@@@@
@@@@........@.@...@@
@@@@@.@.@.@.....@.@@
@@@@@@@@@@..@.@@@..@
@@@@@@@.@.@.@.@@..@.
@..@@@.......@.@@...
..@.@@@.@@@.@...@.@@
@...@@.@.@@@.@@.....
@.@....@.@@....@.@.@
@.@@.@.@..@@.@..@...
@@@@@....@...@.@@@@.
@.@@.@.@@.@@.@@@@...
.......@..........@.
@.@@.@..@.@.@.@.@..@
..@.@..@...@...@@@..
@....@..@.@.@.@@@.@@
..@.@.@.@....@.@..@@
@@....@@.@@.@...@.@@
@@@.@.......@.@.....
@@@..@.@.@@....@.@.@
4
5 14 0
9 13 0
1 12 1
2 5 2

19 12 0
19 11 0
1 15 1
5 14 2
