width 20
height 20
.@.@...@@.@...@.....
...@.@......@@@@.@.@
@@...@@.@.@.@.@...@.
@..@@@.@..@.@..@@...
..@.@@...@.@.@.@.@.@
@.....@@@...........
@@@.@@.@.@.@.@.@.@.@
@..........@@@@..@@@
@@@@@@.@.@..@@@@.@.@
@@@@@@@...@..@@.....
@@@@@@@@.@@@@@.@.@@.
@@@@@@@@@@@.@...@...
@@@@@@@@@@....@@.@.@
@@@@@@@@@@@.@.......
@@@@@@@@@@@@..@.@@.@
@@@@@@@@@@@.@.@...@.
@@@@@@@@@@.....@.@..
@@@@@@@@@@@@@.@.@.@.
@@@@@@@@@@@@@...@...
@@@@@@@@@@@@..@...@.
4
4 0 0
14 3 0
19 2 1
6 6 2

0 1 0
9 9 0
6 7 1
19 2 2
