width 20
height 20
@.@.@.@.@@@@@@@@@@@@
.........@@@@.@@@@@@
@.@@@@@@@@@@...@@@@@
..@.@.@.@@@@@.@.@.@@
@........@@@@.....@@
..@.@@@@..@@@@.@.@.@
@@@..@.@.@.@.@@.....
@@..@...........@@.@
@@@@@@.@.@@@.@.@....
@@@@@@..@.@...@.@@.@
@@@@@@@@...@@....@.@
@@@@@@@@.@.@@@.@@@..
@@@@@@@@@...@.....@.
@@@@@@@.@.@..@.@.@.@
@@@@@@.....@.@@..@..
@@@@..@@@.@.@.@@...@
@@@..@.@.........@@@
@@@@.....@.@@@.@.@@@
@@@@@.@.@....@..@.@.
@@@@...@@@.@..@.....
4
11 7 0
15 9 0
6 4 1
9 14 2

7 17 0
9 5 0
16 10 1
9 7 2
