width 20
height 20
@....@.@@@@@@@.@.@..
.@.@...@@@@.@.....@.
....@.@@@@....@.@...
.@.@.@@@@@@.@..@..@@
.@@...@@@@@@@@@@@...
.@.@.@@@@@.@@@.@..@.
.......@@...@..@.@..
.@@.@.@..@.@.@.@.@.@
..@.@.@@.........@@@
.@.@.@.@.@.@.@.@....
........@.@.@.@..@.@
@.@.@.@.@.......@...
@..@@@..@@.@@@@..@.@
@@@@@@@........@@.@@
@@@@@@@@.@.@.@.@..@@
@@@@@@@@..@...@@@..@
@@@@.....@@@.@.@.@.@
@@@@@.@.@@@.........
@@@@@@@@.@@@@.@.@@@.
@@@@@@@........@@@@.
4
0 5 0
13 10 0
12 9 1
17 1 2

9 13 0
8 8 0
14 0 1
5 1 2
