width 20
height 20
@@..........@.......
@..@.@.@.@.@..@@@@.@
.@..@..@@....@.@.@@@
...@@@@.@@@@.......@
.@....@...@..@.@.@..
..@@@...@.@@..@@.@.@
.@....@..@...@..@...
.@@.@@..@.@@.@.@.@.@
.@....@.@...@@......
.@@.@@.@.@.@.@.@.@.@
@@@..@...@......@@..
@@@@@..@...@.@.@...@
@@@@.@..@.@@@@@@@.@@
.@@..@.@.@.@.@.@.@..
.@.@...............@
.....@.@@.@.@.@.@@..
@.@.@.@..@...@@@.@.@
@@......@.@.@@@....@
@@@.@@.@.....@@@.@.@
@@@@...@@.@.@@@@@..@
4
12 10 0
9 11 0
18 5 1
15 15 2

4 10 0
2 1 0
12 11 1
8 0 2
