width 20
height 20
@@@@.@@@@@@@@.@@...@
@@....@@@........@..
...@.@.@.@.@@.@.@..@
.@@.......@.@@.@.@.@
...@.@.@@...........
@.@@@@..@.@.@@.@.@.@
@.@@@@@.@.@@@.@@@..@
@@@@@@@@..@.......@.
.@@@@@@@@.@.@@.@.@..
..@.@@@@...@@.@.@.@.
@.@..@.@@.@.@.......
....@..@......@.@.@.
.@@..@.@.@.@.@.@@@..
...@......@@.@.....@
.@..@.@.@.@@..@.@@..
..@.@@.@.@@@.@@@...@
@..@.@...@@.@.@@@.@@
@.@....@.......@@..@
@@.@.@.@@.@.@.@.@.@.
......@@@..@........
4
8 11 0
8 2 0
4 0 1
14 1 2

2 18 0
1 15 0
5 1 1
16 3 2
