width 20
height 20
@@@@.@@..@..@.@.@@@@
@@@..@..@@@.....@@@@
@@.@..@..@.@@@@.@@@@
@....@..@@...@....@@
.@.@@.@..@.@.@.@@@.@
........@.@.........
@.@.@.@...@@@.@.@@.@
.@@..@..@...@.@@.@..
...@@@@.@.@@.@.....@
.@...@@@..@....@.@@@
@.@.@.@.@..@.@..@..@
..........@@.@@@..@@
@.@.@@.@@.@......@.@
@..@@@@.@@@@.@.@....
@.@.@@......@.@.@@@.
.....@.@.@@.....@.@.
@.@.@...@...@.@.....
@@..@@.@.@.@.@..@@@.
@.@.@.@@......@@.@@.
.........@.@.@......
4
16 13 0
1 5 0
0 11 1
9 11 2

16 7 0
14 4 0
8 2 1
8 17 2
