width 20
height 20
@@@@@@.............@
@@@@@@@.@.@.@@.@@@@@
@@@@@@...@..@..@.@.@
@@@@@.@.@@@..@......
.@@@...@.@@.@@@@.@@.
..@.@.@..@...@@@@.@.
.@.....@..@.@@......
..@.@@..@....@@.@.@.
@.@@...@@@@.@..@@@..
.....@.@@@@@..@.@.@.
.@.@..@.@.@.@.......
..@@@.........@.@@.@
.@@@@.@.@.@.@@.@@...
..@@@@..@@.......@@@
.@@@@@@@@@@.@.@.@@@@
.@@@@@.@@@@@@@@...@@
@@@@@@.@.@@.@.@.@..@
@@@@@@........@@@.@@
@@@@@@@@@.@.@......@
@@@@@@@@@@@@@.@.@.@@
4
16 10 0
17 16 0
4 10 1
13 0 2

1 13 0
12 13 0
7 5 1
12 3 2
