width 20
height 20
@@@@...@@.@..@..@@..
..@@@.@.@...@..@...@
.@@@@.....@...@.@.@.
..@...@.@..@@...@...
@...@.@..@.@@.@.@.@.
..@..@.@.@.@@@@..@..
@..@....@.@.@@@.@.@.
..@..@.@..@..@......
@..@..@@@...@@@.@.@.
..@.@@@...@..@.@..@.
@.@..@.@.@.@...@.@..
@.@@....@....@@@@@@.
.....@.@@@.@@@@@@@@.
@.@.@@@@@...@@@@@...
.@...@@@@.@.@@@@.@.@
..@.@.@@...@..@.....
.@@...@..@.@.@.@.@.@
....@..@..@@......@@
.@.@..@@.@.@.@.@.@@@
@...@......@@@@..@@@
4
15 17 0
1 5 0
4 3 1
16 14 2

2 18 0
0 15 0
12 2 1
8 19 2
