width 20
height 20
...@@@....@@@@@@@@@@
@.@.@..@.@@.@@@@@@@@
......@.......@.@@@@
.@.@.@.@.@@@@@...@.@
@.@.....@@@....@@...
@...@.@@.@.@.@....@@
..@@.@.@.....@.@.@@@
@........@.@.@.@..@@
.@.@.@.@..@.@...@@@@
.@@.@..@.@...@.@@@@@
....@@@....@@....@@@
@.@.@@.@.@@.@@.@@.@@
@@..........@.....@.
@..@@.@.@.@..@.@@.@.
..@..@...@..@.@@..@.
@...@.@.@@@...@..@..
..@....@@@..@@.@.@@.
@@.@.@@@@..@@@......
.......@..@.@..@.@@.
.@.@.@.@.@....@@@@@@
4
16 15 0
14 16 0
11 11 1
16 12 2

0 0 0
8 6 0
12 19 1
2 8 2
