width 20
height 20
...............@.@@@
.........@.......@@@
.....@.......@...@@@
...............@@@@@
...@.....@.@...@@@@@
..@.@...............
.......@............
.@......@...........
................@...
....@.......@@......
............@@......
....................
......@....@......@.
.........@.@........
...@........@.@.....
.@..................
.........@..........
......@........@....
.................@..
........@...........
11
16 2 0
2 10 0
6 0 0
14 11 0
10 11 0
13 8 0
1 16 0
17 11 0
4 11 0
7 1 0
8 18 0

11 8 0
19 18 0
15 10 0
2 0 0
7 18 0
16 9 0
1 10 0
1 3 0
9 15 0
15 15 0
9 6 0
