width 20
height 20
.@@@@@@@@@..........
.@@@@@@............@
..@@@.............@.
............@.......
.................@..
..........@.........
....................
.....@............@.
................@...
.@..........@.......
....................
........@.......@...
...@.....@..........
.....@......@@......
............@@@.....
....................
........@...........
...............@....
.....@...@..........
..@.................
11
13 10 0
7 16 0
2 11 0
17 12 0
17 11 0
15 13 0
1 12 0
9 11 0
17 13 0
19 15 0
13 16 0

2 3 0
18 0 0
0 11 0
0 2 0
19 16 0
17 16 0
5 5 0
2 13 0
13 8 0
14 7 0
17 17 0
