width 20
height 20
@@..................
@@.....@.........@..
....................
....@...............
......@.............
@@@......@..@.......
...............@....
....................
....@....@..........
..@..........@.....@
.................@.@
.......@............
...............@.@..
..@...@.@..@........
@................@..
....................
....@.@......@......
....................
@.............@.....
@...........@.......
11
8 10 0
16 14 0
10 11 0
2 1 0
0 6 0
13 8 0
14 14 0
18 9 0
18 6 0
9 3 0
8 0 0

5 13 0
0 11 0
2 12 0
4 12 0
3 6 0
3 2 0
19 15 0
5 17 0
9 2 0
0 16 0
15 19 0
