width 20
height 20
..@@@@@.............
..@..@..............
..........@.........
...@........@.......
.......@@.....@.....
........@...........
........@@...@.@....
...@.....@..........
..@.................
............@.......
........@...........
...@.@@.........@...
........@...........
...........@....@...
@@.......@..........
@..@.............@..
.....@...@..........
.......@............
....@............@..
................@@.@
11
6 15 0
14 1 0
15 17 0
8 0 0
15 14 0
9 4 0
4 11 0
1 16 0
17 8 0
17 6 0
16 14 0

1 10 0
19 3 0
18 16 0
13 4 0
16 14 0
8 19 0
0 18 0
9 15 0
4 15 0
13 0 0
8 15 0
