width 20
height 20
..............@.....
............@.@.....
....................
.......@.......@....
....................
............@.......
...@.......@........
.......@.......@....
....@........@..@...
..@..@@.............
.................@..
@............@......
@......@........@...
.....@..@..@..@.....
..........@.........
....@......@........
...@................
....................
...................@
......@.......@....@
11
16 18 0
3 17 0
3 11 0
7 15 0
12 10 0
9 1 0
2 18 0
2 14 0
19 13 0
9 8 0
7 18 0

1 6 0
5 0 0
10 16 0
16 0 0
12 10 0
10 0 0
19 11 0
9 19 0
6 11 0
7 10 0
16 10 0
