width 20
height 20
....................
.....@..............
.@....@.............
.....@..............
....@...........@...
..@......@....@.....
....@...............
@...................
@...................
@..@...........@..@.
...........@........
........@...........
..@...@.............
@..@.@..............
..........@.......@.
...............@..@.
@.@.....@.....@.....
....@...............
@.............@.....
@......@...........@
11
3 17 0
10 4 0
7 16 0
0 11 0
11 16 0
5 11 0
10 17 0
18 6 0
5 16 0
9 14 0
19 3 0

11 15 0
10 4 0
7 0 0
18 1 0
11 11 0
9 11 0
10 17 0
18 0 0
12 11 0
9 14 0
17 14 0
