width 20
height 20
.............@@@@@@@
..........@.....@@@@
...@@@..........@@@@
........@...@..@@@@@
..............@....@
..@.................
.....@.............@
..@.........@.......
.......@.........@..
..@.....@.@...@.....
....@.........@...@.
@...................
@....@..............
...........@........
....................
..@.................
.....@.........@....
@@.......@..........
@@......@.....@.....
@@..........@......@
11
7 0 0
3 1 0
4 15 0
11 15 0
15 12 0
19 15 0
9 16 0
12 8 0
10 8 0
13 6 0
2 17 0

7 0 0
6 5 0
4 14 0
1 0 0
17 10 0
14 15 0
18 16 0
16 8 0
9 6 0
0 1 0
18 11 0
