width 20
height 20
...................@
...................@
................@@.@
..........@.....@...
..@@....@...........
......@..........@..
.....@......@.....@.
.......@............
................@...
...........@........
.@....@.....@...@...
.............@......
.......@....@.......
..@.@.@..@.....@....
.............@......
......@.............
..............@.....
..........@.....@...
........@...........
....................
11
3 17 0
13 18 0
19 8 0
10 13 0
12 19 0
1 5 0
2 19 0
17 17 0
12 17 0
19 3 0
14 15 0

19 3 0
3 12 0
16 11 0
17 3 0
5 7 0
11 1 0
8 5 0
9 12 0
0 6 0
1 3 0
15 14 0
