width 20
height 20
@@@.................
........@....@......
..........@.........
....................
.@@.@..@...........@
.@@........@........
....@.......@.@.....
........@...........
..........@.........
....@.@.............
....................
......@...@..@...@..
.....@..@...........
....................
..@..@.....@...@....
....@...............
........@@....@...@.
...@...@@@.......@..
@.....@@@@....@.....
@.....@@@@.........@
11
1 19 0
12 10 0
15 5 0
7 15 0
16 2 0
11 11 0
18 1 0
2 7 0
18 8 0
8 2 0
11 8 0

14 11 0
6 4 0
19 12 0
18 17 0
18 2 0
8 10 0
2 11 0
19 13 0
16 16 0
7 14 0
1 18 0
