width 20
height 20
.......@..@@@.......
..........@@....@..@
...................@
....................
............@......@
.....@.......@......
..@.............@...
.@............@....@
.......@...........@
...@.........@.....@
......@.@@..@......@
......@.............
.........@...@....@.
.......@............
........@....@......
..................@@
..........@...@....@
.....@.............@
.......@............
.@.............@@@..
11
2 9 0
11 15 0
0 17 0
19 5 0
11 12 0
11 4 0
10 11 0
3 0 0
5 18 0
1 13 0
7 19 0

5 8 0
15 12 0
2 8 0
19 12 0
14 10 0
16 16 0
17 1 0
15 0 0
2 19 0
13 18 0
0 11 0
