width 20
height 20
....................
..........@..@......
.......@.......@....
.@.....@..@.........
.......@............
...........@.@......
..@.................
@.................@.
.................@..
...........@........
....................
..@.....@....@.@.@..
.......@............
...........@....@...
......@........@....
....@......@.......@
............@......@
..@.......@.........
..............@..@@.
.....@...........@@@
11
2 5 0
2 2 0
14 7 0
14 13 0
1 7 0
1 2 0
19 17 0
8 3 0
17 6 0
7 0 0
7 6 0

19 10 0
3 5 0
3 19 0
13 15 0
7 13 0
2 5 0
3 8 0
3 16 0
5 3 0
18 17 0
16 18 0
