width 20
height 20
....@..............@
....................
........@....@@..@..
.............@......
..@.................
..@...@............@
.........@......@..@
...@.....@....@.....
....................
@@.......@..@.@...@@
........@....@......
...............@....
.....@......@.......
.......@............
....................
....@...............
........@......@....
...@@...............
...@@...............
.@...............@..
11
3 13 0
7 8 0
15 7 0
7 19 0
15 2 0
17 13 0
3 3 0
18 12 0
14 15 0
17 4 0
13 6 0

2 11 0
6 9 0
19 8 0
15 5 0
13 4 0
15 12 0
5 14 0
18 12 0
3 15 0
19 12 0
17 16 0
