width 20
height 20
........@...........
..@.................
.....@.........@@...
.........@....@@@...
....................
.....@............@.
@......@............
@.........@......@@.
...@....@..@........
.@..................
.......@.......@....
...@................
..@.........@.......
@.....@..@..........
.....@..............
...@..@....@......@.
.............@......
......@...@....@....
..................@.
....................
11
6 7 0
17 4 0
19 7 0
3 10 0
14 0 0
6 1 0
9 9 0
2 19 0
19 15 0
16 10 0
16 7 0

15 16 0
19 4 0
2 15 0
11 13 0
17 16 0
19 19 0
14 11 0
10 6 0
14 7 0
4 19 0
9 5 0
