width 20
height 20
...........@.......@
........@...........
......@..@..........
....@.....@.........
............@....@..
..@....@............
@....@..............
..........@.@...@...
....@.@........@....
.........@........@@
........@.@.......@@
.............@....@@
.....@..@.@....@.@@@
..................@@
.....@..............
..............@...@.
..@.................
....@@@.............
.....@........@.@...
....................
11
17 5 0
19 3 0
3 17 0
4 15 0
15 13 0
8 9 0
12 3 0
15 10 0
14 9 0
6 11 0
17 13 0

6 18 0
19 17 0
1 13 0
1 8 0
0 5 0
19 18 0
6 6 0
11 18 0
12 13 0
3 5 0
13 9 0
