width 20
height 20
@@@@@@@@@@@@@.......
@@@@@@@@@@@@@.......
@@@@@@@@@@@@.....@..
...@@@@@@@@.........
..@@@@@@@@@......@..
..@..@@@@@@@@....@..
.....@@@@@@.....@...
.....@@@@@@.........
.......@............
..@............@....
....................
@...........@.@.....
..@.................
......@...@.........
......@.............
....................
..........@.@.@.....
....@@............@.
@...@@..............
@...@@@.............
11
7 9 0
11 3 0
19 14 0
5 10 0
12 15 0
19 7 0
14 2 0
19 17 0
19 18 0
9 18 0
1 15 0

13 1 0
15 0 0
19 17 0
0 16 0
12 19 0
2 17 0
15 2 0
19 15 0
0 4 0
15 17 0
14 4 0
