width 20
height 20
@@@....@.........@..
@@@......@.....@....
@@@..@..............
@@@.......@..@......
..@.@.@........@....
....@@....@.........
..@.........@.@.....
....................
.....@...........@..
....@...............
...........@..@.....
.@@.....@...........
.@..@.........@.....
.......@............
............@.......
....@...............
......@.............
..@@................
..............@.....
....................
11
10 9 0
18 6 0
18 11 0
18 2 0
7 16 0
0 13 0
16 3 0
9 16 0
11 4 0
0 18 0
18 1 0

18 5 0
6 11 0
18 11 0
3 11 0
19 10 0
19 9 0
2 12 0
19 0 0
2 18 0
10 14 0
0 14 0
