width 20
height 20
...........@........
......@.............
................@...
..@..@...@.....@....
........@.........@.
.......@...@........
..@...@....@..@.....
........@......@....
....................
....@.........@.....
....................
.....@..@...@..@....
...........@........
...@.@.@....@.....@.
....................
....................
..@...@.@...........
....@.........@.@...
....................
.......@...........@
11
4 6 0
11 11 0
15 19 0
16 5 0
6 14 0
17 11 0
13 16 0
10 10 0
17 18 0
0 14 0
14 19 0

18 19 0
8 12 0
1 3 0
18 2 0
6 15 0
0 12 0
3 9 0
13 9 0
4 0 0
9 11 0
16 3 0
