width 20
height 20
.............@@@...@
......@.............
....@...@...........
...................@
@..........@........
@...@......@.......@
..................@@
..@........@.....@@@
.....@...........@@@
..........@...@.....
........@..........@
....@...............
................@...
...................@
...@.......@@.@.....
....@...............
...........@........
....@.@..@..........
....................
.@....@@@.......@@..
11
10 18 0
16 7 0
15 4 0
17 17 0
18 2 0
2 6 0
1 12 0
14 6 0
9 7 0
2 3 0
10 2 0

19 4 0
19 9 0
13 3 0
1 1 0
18 14 0
1 8 0
18 0 0
2 19 0
5 13 0
3 15 0
17 11 0
