width 20
height 20
....................
@...................
@......@............
...........@........
....@...............
...............@....
.@..@...............
.......@.@........@.
...@...@.....@.@.@..
.@........@.........
.....@........@.....
................@...
..@...@...@.........
....................
@........@..........
@..@................
......@.....@.....@@
.........@.......@@@
..............@@@@@@
..............@@@@@@
11
18 8 0
12 8 0
5 19 0
18 14 0
3 11 0
6 11 0
5 14 0
6 8 0
11 13 0
12 18 0
6 7 0

2 4 0
2 18 0
10 17 0
8 9 0
4 15 0
5 0 0
18 12 0
9 6 0
5 11 0
6 5 0
6 6 0
