width 20
height 20
@@@@@@..............
.@........@........@
.....@.........@....
..@......@..........
............@.@.....
..@.................
@.............@.....
...........@.....@..
..@............@....
......@.....@.......
....................
..........@.........
.................@..
.......@...@..@..@..
..@............@....
.......@............
..@...@.............
....................
....................
...........@........
11
3 19 0
13 1 0
16 10 0
0 7 0
11 17 0
16 11 0
3 16 0
7 9 0
16 13 0
13 9 0
9 0 0

14 3 0
0 9 0
3 16 0
5 5 0
0 1 0
19 3 0
6 7 0
18 0 0
6 3 0
5 19 0
9 0 0
