width 20
height 20
.........@.@@@@.....
@@.........@@@@.....
@@@.................
@@.....@........@...
......@.............
............@.......
.@..................
..............@..@..
........@......@....
....@...............
.......@...@.....@..
....................
.........@....@.....
......@.............
....................
..@.@..@..........@.
..............@.@...
...@....@...........
....................
.....@..............
11
16 15 0
19 11 0
11 15 0
6 15 0
8 9 0
13 16 0
14 2 0
18 10 0
16 11 0
18 4 0
8 15 0

19 11 0
18 10 0
9 14 0
5 1 0
7 12 0
7 0 0
7 18 0
12 8 0
9 16 0
10 14 0
10 13 0
