width 20
height 20
@@@@...............@
.@@@...............@
............@......@
....@..@...........@
..@......@.@.......@
.......@.........@..
...............@....
....@......@........
.....@.@.@.......@..
...@..............@.
...........@........
..@.......@...@.....
......@.........@...
..................@.
@......@......@.....
@.........@.....@...
....................
...@..@.....@......@
.......@........@..@
....................
6
19 11 0
13 11 0
12 11 1
16 5 1
15 5 2
9 18 2

15 18 0
4 11 0
0 1 1
1 5 1
19 15 2
1 9 2
