width 20
height 20
....................
....................
.................@..
.@.@......@.........
....................
....@...@...........
.@...........@......
......@.............
.....@..............
......@.@..@........
...............@....
..@.........@.......
...@..........@.....
.......@............
................@...
..@...@.............
...................@
..@.......@.@.....@@
.....@.@@.........@@
.....@@@@@.........@
6
5 9 0
0 15 0
6 18 1
17 14 1
9 16 2
16 1 2

13 19 0
11 2 0
19 1 1
2 0 1
15 2 2
16 0 2
