width 20
height 20
@.@...........@@@@..
..............@@@@..
@....@.......@......
....@...............
...@................
@.........@..@.@..@.
@@..................
..@.................
........@....@...@..
...........@........
....@.......@..@....
..................@.
.........@..........
....@...............
...............@....
....@.......@.......
..@............@....
..@....@.@.......@..
....................
.............@......
6
2 3 0
5 19 0
11 4 1
7 8 1
2 11 2
19 16 2

13 14 0
16 3 0
10 1 1
19 18 1
18 1 2
6 6 2
