width 20
height 20
.........@@......@@@
.....@.............@
...................@
...................@
.@...........@@....@
..........@.........
.......@..@.....@...
..@...@...@.........
.........@...@.....@
.....@.......@......
........@......@....
....................
....................
..@.................
........@...@.......
...@......@.........
.............@....@.
@....@..............
@@..................
@@@@..............@.
6
17 5 0
13 0 0
5 2 1
10 10 1
16 0 2
10 12 2

8 13 0
12 8 0
19 12 1
8 8 1
1 6 2
7 13 2
