width 20
height 20
....................
...@...............@
.....@...@........@@
...........@......@@
...@........@.....@@
...............@....
..@.................
....@.........@.....
.......@........@...
..@.......@.........
.......@....@.......
.@.@.@..............
.@..................
......@.@.@.........
.............@......
....@.......@....@..
.....@....@.........
....................
...............@....
..................@.
6
16 19 0
1 0 0
18 18 1
17 2 1
8 19 2
3 0 2

8 5 0
4 12 0
3 5 1
9 10 1
14 14 2
16 13 2
