width 20
height 20
......@.............
..@.................
....................
.....@....@..@..@...
........@....@......
.@.@.....@..........
..@.................
................@...
....................
................@...
.........@..........
@.....@.@...@...@...
@.@.@........@..@...
@...................
.................@..
...........@.......@
...@.......@@.......
.........@@@@@.@....
.........@@@@@......
.........@@@@@......
6
4 18 0
1 16 0
8 17 1
3 6 1
4 15 2
15 11 2

12 2 0
15 4 0
8 17 1
10 4 1
11 12 2
17 0 2
