width 20
height 20
@@...............@.@
.............@......
........@.@.........
...@................
..@.................
.............@......
....@......@........
........@.....@..@..
....................
........@.@.........
...@.@.......@....@@
...@...@......@...@@
.@................@.
..@@................
.............@......
....................
.......@............
..@.........@.......
.....@...@.@........
....................
6
1 19 0
9 6 0
17 18 1
7 6 1
11 9 2
9 1 2

2 19 0
3 16 0
19 2 1
5 16 1
6 11 2
10 1 2
