width 20
height 20
..................@@
....................
.@........@...@.....
.........@..........
.....@.....@...@....
...@......@.@......@
..................@.
...........@...@.@..
...@.....@..........
........@..@........
...@.........@.@....
.......@............
..@.................
...@.......@........
.@............@..@..
...........@........
..@..............@..
.........@.........@
....................
...................@
6
5 14 0
10 18 0
15 16 1
10 0 1
15 5 2
5 9 2

4 5 0
19 9 0
2 19 1
1 18 1
5 17 2
9 1 2
