width 20
height 20
...........@........
....................
............@.......
....................
....@...............
...@......@.........
@.....@.............
@......@.@..........
@.................@.
.............@......
@......@.@.@........
@...................
.........@.....@....
..@@.......@.@...@..
..@@................
...@....@...........
.................@..
....................
....................
.......@@@@@........
6
11 6 0
9 4 0
10 7 1
4 17 1
2 3 2
8 16 2

0 16 0
17 12 0
5 18 1
4 17 1
3 2 2
19 19 2
