width 20
height 20
............@.......
@.....@...........@.
@...................
..@.......@.........
...@.....@...@.@....
....................
......@.....@.....@.
....@...............
....................
......@..@..........
........@..@.@......
..............@.....
..@..@..............
......@....@.@......
....@.......@.......
...............@..@.
...........@........
........@...........
...@......@....@....
..@@@...............
6
12 13 0
7 12 0
1 14 1
16 16 1
0 18 2
2 13 2

13 12 0
6 14 0
5 17 1
15 3 1
1 13 2
17 12 2
