width 20
height 20
.....@.....@........
...@................
....@...............
.....@..............
.@.........@....@...
........@...........
..............@.@...
.@..................
....................
.@.........@.@.@....
.......@....@....@..
........@.........@.
....@...............
.........@.....@....
....................
...................@
....................
........@.@........@
....................
...............@....
6
18 16 0
13 4 0
0 2 1
7 16 1
19 7 2
18 12 2

2 2 0
18 17 0
1 3 1
15 12 1
3 18 2
2 4 2
