width 20
height 20
......@..@..........
....................
..@..........@..@...
...........@........
......@.............
....................
....@.@...@.@.@.....
........@..@.@......
..@...............@@
.........@......@..@
....................
..@....@............
.....@...........@..
..@@......@..@......
@.@@...@.......@....
..@@....@..@....@...
............@.......
..............@.@...
@....@..............
....................
6
0 15 0
12 8 0
5 17 1
15 16 1
19 15 2
4 1 2

3 12 0
1 19 0
19 18 1
3 19 1
7 9 2
17 3 2
