width 20
height 20
....@...............
...............@....
........@...........
....@...............
.........@...@...@.@
..........@.........
@...@.........@.....
.......@........@...
....@...@...........
..@...............@.
.............@......
..........@.........
.........@..@..@....
.@.@.............@..
........@.....@.....
......@....@...@....
........@........@..
.@........@.........
................@...
........@...........
6
0 2 0
12 15 0
2 2 1
4 11 1
11 5 2
16 0 2

13 9 0
13 15 0
17 19 1
8 3 1
11 5 2
14 9 2
