width 20
height 20
.@.......@@..@@@@...
...................@
@.......@.......@..@
@...........@.......
.....@..............
....@.........@@....
....................
........@...........
.............@.@....
.@@........@........
...........@........
.............@......
....@..@..@.........
..@......@.....@....
..............@.....
....................
.....@..............
..........@.........
....................
.............@@.....
6
16 9 0
6 15 0
9 10 1
14 13 1
5 7 2
10 19 2

3 10 0
12 10 0
12 11 1
17 11 1
15 15 2
17 15 2
