width 20
height 20
.@@@@@@@............
...................@
...@.@.............@
..@.@.@...@........@
..............@....@
@..................@
@...@...........@...
....................
....@...@.@.........
.....@..............
..................@.
....................
..@.@...............
...@..@........@@...
..........@.........
.@.@...@....@......@
....................
......@.....@.......
...@.............@..
............@@......
6
3 7 0
1 9 0
4 19 1
5 13 1
10 7 2
13 10 2

7 4 0
9 8 0
10 4 1
19 0 1
0 13 2
0 2 2
