width 20
height 20
...@@........@..@@..
...@@...........@...
...@...........@....
................@...
....@.@....@........
.@........@.........
....@............@..
........@....@......
@@...@.........@....
...........@....@...
...............@....
......@.@...........
..............@.....
......@...@.........
...........@.....@@.
...@.............@@@
...............@....
....................
........@....@......
@..@.........@...@@@
6
0 13 0
14 7 0
4 19 1
8 5 1
7 8 2
8 14 2

19 5 0
0 17 0
19 0 1
19 1 1
2 15 2
15 5 2
