width 20
height 20
....@...............
....................
..@.@......@......@.
.@.....@.....@......
................@...
....................
.@......@.@.@.......
..@.................
......@.............
............@.@.....
.........@...@......
......@.@.......@...
...............@....
.@..@...............
..........@..@@.@...
........@...........
................@...
...................@
...@..........@....@
...................@
6
15 15 0
16 5 0
10 17 1
9 6 1
0 11 2
16 15 2

1 1 0
11 19 0
17 1 1
12 19 1
17 17 2
16 13 2
