width 20
height 20
......@............@
...@................
.................@..
...@................
.@....@.@...........
...@...@............
..@.................
........@...........
...@.....@....@@....
....@..@....@.@@....
...............@....
....................
..@......@.....@....
....@.....@.........
.........@..........
...@..@...@..@......
....................
........@....@......
....................
....................
6
0 11 0
12 10 0
11 17 1
8 18 1
18 12 2
2 11 2

0 11 0
4 4 0
1 0 1
7 6 1
1 18 2
14 2 2
