width 20
height 20
@.....@.@@@@@..@@...
@@@.@....@@@@@..@.@@
@@.@.@.@..@@@.@.....
@....@.@@.@@....@.@.
..@@..@....@.@@@.@..
@.@.@..@.@........@.
.....@.@@@.@.@@.@@@.
@.@.@@......@.@..@.@
...@@.@.@.@@..@.@...
@.@.@....@.@@.@.@@.@
....@.@.@@.....@@@..
@.@..@@@...@.@.....@
@@..@.@@.@@@@@@.@@..
@@@..........@...@@@
@@..@.@.@.@.@@@.@@@@
@.@.@..@@@.@@@@...@@
....@.@@@@.@@@@@.@@.
.@.@@...@@..@@@@....
..@@@.@.@@.@@@@@.@.@
.@@@@..@..........@@
1
9 4 0

1 10 0
