width 20
height 20
@@@@@@@@@@.@..@.@@@@
@@@@@@@@@...@.@....@
@@@@@@@@@@@.....@.@@
@@@@@@@@@@@.@.@..@@@
.@@@.@.@@@@@@@..@@@@
..@.....@.@.@@@..@@@
.@@@.@.@.....@@.@.@@
..@@@....@.@@@..@...
.@.@.@.@@.@.@.@...@.
................@..@
@.@.@@@@.@.@.@.@..@@
...@@.....@..@@.@..@
.@@.@.@.@@.@.....@.@
@......@...@.@.@..@@
..@.@.@@.@.@@...@.@@
@..@.@....@..@.@@@.@
..@....@@@..@@......
@.@@.@.....@.@.@@.@.
@@@@@..@.@.....@@@..
@@@@@@..@@@@.@.@@..@
1
12 17 0

6 15 0
