width 20
height 20
....@....@..@@@.@..@
.@.@.@.@@@@..@..@@..
@........@..@.@.@..@
.@.@@@.@@.@......@..
......@.....@@.@.@.@
.@.@.@..@.@..@@@@...
..@@@@.@@.@@@@..@@.@
.@.@.@...@..@..@.@.@
...@...@@..@.@.@....
.@...@@@.@.......@.@
..@@.@....@@.@@@@..@
.@.@@.@@.@@....@@@..
.........@.@.@@.@@@.
.@.@@.@@.........@..
@@@..@@@@.@@@@.@@.@.
@@..@@@@....@@@.@.@.
@@.@.@@.@.@..@@....@
@........@.@.@.@@@.@
@@.@.@.@.@.@.....@.@
@..@.@@......@.@....
1
18 0 0

0 6 0
