width 20
height 20
.@.@.@..@...@@@@@@.@
......@...@.@.@.@...
@@.@.@..@.@@......@@
@@@....@.@..@@@.@.@.
.@.@.@.....@@....@..
......@.@@..@.@.@@.@
@.@.@@.@@..@...@@@.@
...@.@.@.@.@@.@@@...
@.@.........@....@@.
..@@.@@.@@@@..@@....
@.@..@.@@@@..@...@.@
...@...@@@@@@.@@..@.
@@@.@@..@@@......@@.
@......@.@.@.@.@..@.
@@.@.@........@@@...
@.@@..@@.@.@.@@@@.@.
.....@@@@@@@@@@..@..
.@.@@@@@@@@@@@@@..@.
..@@@@@@@@@@@@@@@...
@@@@@@@@@@@@@@@@..@.
1
4 3 0

13 11 0
