width 20
height 20
@.@.@@@@...@.@.@@@@@
....@@@.@.@.....@..@
@.@..@....@.@.@...@.
..@@@.@.@@.@.@.@@...
.@@..............@@.
....@.@.@.@.@.@@....
.@@..@..@@@..@...@.@
..@.@.@.@...@@@.@...
.@.@@..@@.@..@.@@@.@
.....@.@.@.@@..@@@@.
@@.@.......@.@..@.@.
@...@.@@.@.....@....
@@.@@..@@.@.@@...@@.
@@@...@.@.@@@@@.@@..
@@@.@.......@@@@@..@
@@@.@@.@.@.@@@@@@@..
@@....@.@@..@@.@...@
@.@.@.@..@.@.@...@..
...@@..@.....@.@..@.
.@....@..@.@.@.@.@..
1
15 17 0

12 0 0
