width 20
height 20
...@..@.@.......@@@@
@@.@@.....@@@@.@@@@@
.@.@.@.@@....@..@.@@
.......@.@@.@@@....@
.@@.@@.@.....@..@.@@
@....@@..@.@@@.@....
@.@.@.@@..@@@.@@@@.@
.@....@@.@.@...@.@..
..@.@.@....@@@.....@
.@.@.@@.@@.@.@.@.@..
.....@@@@.....@@@..@
.@@@..@@@@.@.@.@.@..
.@.@.@.@...@.....@.@
@........@..@@.@..@@
.@@.@@.@..@..@.@.@@@
......@.@.@.@.@@.@@@
@.@.@...@@.@......@@
@@@@@.@.@....@.@.@@@
@.....@@@@.@..@@.@@@
@.@.@.@@@@@..@@@@@@@
1
1 5 0

2 15 0
