width 20
height 20
@@.@...@@@@@@.@.@.@.
@....@...@@@........
@@@.@..@@.@.@.@.@.@.
@@@..@.........@@@..
@@@@@@@.@@.@.@@.@.@.
@@@@@@@.@.@.@.......
@@@@@@@@......@.@.@.
@@@@@@@@@@@.@..@...@
@@@@@@@@@@@..@..@.@@
@@@@@@@.....@@.@....
.@@@@@@@.@.@..@@@.@.
.@@@..@...@..@.@@..@
.@@.@.@@.@.@......@.
.......@@....@@.@...
@.@.@@@.@@.@...@..@.
@@@.......@@@.@..@..
....@.@.@.@@..@@@@@.
@.@.@@@@.@.@@...@@@@
@@............@.@@@@
@@@@.@.@.@.@.@@.@@@@
1
15 15 0

14 12 0
