width 20
height 20
@@@@@.@@@@@@........
.......@@@@@.@.@@.@@
.@@.@.@.@@@.@.@.@.@.
@@@@................
@@@.@.@.@.@.@.@.@.@.
@....@..@@@@@@.@.@..
.@@.@@@...@.@....@@.
.....@@@@@....@.@...
.@@.@.@.@.@.@@.@.@@.
.@..................
.@.@@@.@.@.@.@.@.@.@
@.....@@@...@@@...@@
@@.@@.@@@@.@.@.@@@..
@@@....@@.......@.@.
@@@.@.@@@@.@.@@.@.@.
@@..@@@@@@@...@.....
@..@@.@@@@@@@@..@.@@
..@....@@@@@@@@..@@.
@...@.@@@@@@@@@@.@@.
..@@..@@@@@@@@@@....
1
3 7 0

14 0 0
