width 20
height 20
@.@..@..@@@@@@@@@@@@
..@.@..@@@@@@@@@@@@@
@.....@.@@@@@@@@@@@@
..@@@....@...@@@@@@@
@..@..@@...@@.@@@@@.
@.@@@@...@@@....@...
...@.@@.@.@.@.@@.@.@
@.@.......@.........
@@@.@@.@@...@.@.@.@.
@@..@@@.@.@@...@@@..
@.@.@@@.....@.@.@@@.
.....@@@.@.@.....@@.
@.@@..@@@@@@@.@.@@@.
@..@.@.@.@.@.@...@.@
..@........@..@.@...
@.@.@@.@.@.@@.@...@@
@@....@.@@@@....@@.@
@@@.@.......@@.@.@..
@@@@..@.@.@@.......@
@@@@@..@..@@.@.@.@@@
1
10 17 0

19 5 0
