width 20
height 20
.........@.@@.@@@@.@
.@@.@@.@...@...@....
@@@@.@@@.@@.@.@.@@@.
@@@@..@.............
@@@..@@@.@@.@@@.@.@.
@@@@..@...@@@..@@@..
@@@@@..@@.....@@@@@.
@@@@@@.@.@.@.@@@@@..
@@@@@......@@@@@@@@.
@@@@@@.@.@@@@@@@@@@@
@@@@@@@@@@@@@@@@@@@@
@@@@@@@@@@@@@@@@@@@@
@@@@@@@@@@@@@@@@@@@@
@@@@@@@@@@@@@@@@@@@@
@@@@@@@@@@@@@@@@@@@@
@@@@@@@@@@@@@@@@@@@@
@@@@@@@@@@@@@@@@@@@@
@@@@@@@@@@@@@@@@@@@@
@@@@@@@@@@@@@@@@@@@@
@@@@@@@@@@@@@@@@@@@@
1
19 1 0

6 6 0
