width 20
height 20
@@@@@@@@@@@@@.@@@...
@@@@@@.@@@.@...@.@.@
@@@@@...@....@@.....
@@@@.@.@@@@.@...@.@@
@@@.........@@.@.@.@
....@.@.@.@........@
@.@.@.@.@.@.@.@.@@.@
...@.@.@.@.@.@.@.@..
@.@..@.............@
...@.@.@.@.@.@.@.@..
@@...@..@.@.@.@.@..@
..@.@@@.@.@.......@@
@.@.@.....@.@.@.@..@
.....@@.@.@@@..@..@@
.@.@@..@@@....@..@@@
..@@.@.@@.@.@..@.@@@
.@@..........@@..@.@
...@.@.@@@@@...@@@..
.@.@..@@@@...@...@.@
..@@@.....@.@..@...@
1
16 14 0

1 7 0
