width 20
height 20
@@..@...@@..@@@@@@.@
@@@.@.@..@.@@@@@@...
@@...@..@...@@@@..@.
@.@@.@.@.@.@@@..@.@.
...@.......@@.@....@
@.@@.@.@.@..@...@.@@
@...@.@.@.@.@.@@@@@@
@.@.............@@@@
.@..@@@.@.@.@@.@@@@@
.@.@@.@@...@....@@@@
..@...@.@.@..@.@@@@@
@..@@....@@@..@.@@@@
..@.@@@.@@...@...@@@
@.@........@.@@.@.@@
....@.@.@@.@.@......
@@@..@@@..@.@@@@.@.@
@@@.@.@@@.@.@@.@@...
@..............@.@.@
..@@.@.@@.@@.@......
@...@@.@....@..@.@@@
1
6 19 0

10 17 0
