width 20
height 20
...@.........@@@...@
.@...@@.@.@.@@@@@@..
..@@@...@@@@.@@@...@
.@..@.@@.@@.....@@..
...@.@.@....@.@@@..@
.@.......@@.@...@.@.
@.@@.@@.@...@.@@....
....@.@@@@.@.....@@.
.@.@...@.@..@.@.@@@@
.@...@.....@.@.@.@..
.@@.@@.@.@@........@
...@.@@@@@..@@@.@@.@
.@@@...@.@.@.@@@....
..@@@@.......@@@@@@.
@......@@@.@@.@@@.@.
@@@@.@.@@@@@@.......
@@@..@@@@@@@@@.@@.@@
@@@@....@@.@@@@.....
@@@@@.@.....@@@@.@.@
@@@@@.@@.@.@@@@@@...
1
11 18 0

5 0 0
