width 20
height 20
......@..@.@@@@@@@@@
.@.@@...@....@@@@@@@
..@@.@@.@.@.@@@@@@@@
.@@...@.@..@@@@@@@@@
@@..@.@...@@@@@@@.@@
.@@@....@@@@@@@@@...
..@@@.@.@..@@@@@@.@.
@..@...@..@.@@.@@@..
@.@.@.@.@......@@@@.
..........@.@@@.@@..
@.@.@.@.@@@@@@@....@
@..@@@@.@@@@@@..@@.@
..@@@.@..@.@.@@...@.
@..@....@.....@.@@..
@.@@@.@@@.@@@@.....@
...@.......@.@@@@.@@
@.@@.@@.@@.........@
@@@@@.@..@@.@.@.@.@@
@@@@....@...@..@@@@@
@@@@.@.@..@.@.@@@@@@
1
13 16 0

7 1 0
