width 20
height 20
@...........@.@.@.@.
@@@.@.@.@.@.........
@@@@@@@.@.@.@.@.@.@.
@@@@@...@@@@.@.@@@..
@@@@.@.@@@.@.@..@.@.
.@@...@....@..@.....
...@.@.@.@...@..@.@@
@@......@..@@.@..@@@
@..@.@.@@@......@@@@
..@.@.@.@.@.@.@.....
@...........@.@.@.@.
@.@.@.@.@.@.@..@@@..
...@@@.@.@.@@.@@@@@.
@.@@.@.@.....@@@..@.
.........@.@.@@.@..@
@.@.@.@.@.@@@@....@.
@@@@@@.....@@@@.@...
@@@@@@@.@.@..@.@.@@.
@@@@@@@@..@@........
@@@@@@@@@....@@@.@.@
1
18 1 0

9 16 0
