width 20
height 20
...@.....@@@@.@.@..@
@@..@.@.@..@....@@.@
...@...@.@.@@.@@....
.@..@@........@.@.@.
@.@...@.@.@.@......@
...@.@@@.@@@..@.@.@.
@.@...@...@@@.@@@.@.
...@.@.@.@.@..@.@@@.
@.@.........@.......
@...@.@.@.@...@@@.@@
..@@.@.@.@.@.@@@..@.
@........@..@.@.@...
..@.@.@.@@.@@.....@.
@.@@@@..@...@.@.@.@.
......@@..@.@..@@@@@
@.@.@...@@..@.@.@.@@
@@..@@.@@@@.@......@
@@@...@@@@..@@.@.@.@
@@@@.@@@@@@....@@@@@
@@@@@@@@@@@@.@@@@@@@
1
1 10 0

14 14 0
