width 20
height 20
@.@.......@@@.@...@@
....@@@@.@.@...@.@.@
@@@...@.....@@......
@..@.@@.@.@...@.@.@.
@@..@@.@.@.@.@.@.@@.
..@.@@...........@..
@......@.@@.@.@.@@@.
..@.@@@@@....@.@.@..
@..@@@@@@.@.@....@@.
@.@.@@@@...@@@.@....
@....@@@.@@@@...@.@.
..@.@.@.@@.@.@.@...@
.@.............@@.@.
..@@.@.@.@.@.@..@...
.@....@.@.@@@@@@..@@
@@.@.@.........@@.@@
@@..@@@@.@.@@@.@@@.@
@@@.@@@@@@@@@...@...
@@@.@.@@.@.@.@.@.@.@
@@..................
1
18 13 0

8 5 0
