width 20
height 20
..@..@.@.@@@@...@..@
.@..@.....@@@.@@.@.@
.@.@@@@@.@.@........
...@@.@......@.@@@.@
.@..@..@.@.@..@@....
@..@.@.@@...@.@..@.@
.@.......@.@@@@.@...
.@.@.@.@.@.@....@@.@
..@...@@@@..@.@..@@@
.@.@.@.@...@.@..@@@@
...@.....@.@...@@@@@
@.@..@.@..@@.@....@@
@.@@..@@@@..@..@.@@@
.....@...@@..@@@@@.@
@.@.@@@.@.@.@.@.@...
...@@@..@........@.@
@.@.@.@...@.@.@@....
@......@@@.@.@.@.@@.
..@@.@............@@
@.@@@..@.@.@.@.@.@@@
1
12 19 0

12 7 0
