width 20
height 20
.....@@..@@......@@.
@@.@@.@@.@@@.@.@.@..
@@........@@.@@....@
...@.@.@.@.@@..@.@.@
@@..@@.@......@.@...
@@@.@...@.@.@.@...@.
@@...@@@...@....@.@.
@@@.@@@@@.@@.@.@.@.@
.@@@@@@...@@@@@....@
.@@@.@..@.......@.@@
...@..@..@.@.@.@@.@@
@.@..@..@.@@@....@@@
@...@@@@...@.@.@..@@
..@@.@...@.....@.@@@
@......@..@@.@..@@@@
.@.@.@.@@@..@.@@@@.@
.@..@@@.@@.@..@@@..@
...@@@@.@....@.@.@.@
@.@.@@@.@@@@........
@............@.@@.@.
1
7 9 0

10 9 0
