width 20
height 20
.@.@.@.......@@@@.@@
.......@.@@.@@@@....
@.@.@.@@.@...@@.@.@@
.@.@.@..@.@.@@.....@
...@..@...@..@@.@.@.
.@...@..@@@.@@...@..
..@@@.@..@..@@@.@.@.
.@....@.@.@..@......
..@.@.......@..@@.@@
.@...@.@.@.@@.@.....
.@@@.@@@@.@....@.@.@
.....@.@...@@.@@..@@
@.@@...@@.@.@@...@.@
@@@@.@........@@....
@.@.@@.@@@@.@..@.@.@
....@.....@@..@@..@@
@.@..@.@.@@.@....@@@
@.@@.@@..@..@.@.@.@@
@@.....@...@@@....@@
@@@.@@...@.@@@@.@.@@
1
4 18 0

5 15 0
