width 20
height 20
@.....@.............
....................
......@..@.....@....
.@..................
...............@....
....@.........@.....
@......@............
@.........@......@..
.......@.....@......
.@...@...........@..
.@.......@..........
@@..................
@@.@..@.............
@........@.@...@....
...@....@...........
.....@..............
...............@....
..@......@..........
....................
..............@@@...
3
8 10 0
15 5 0
3 19 0

8 11 0
14 13 0
18 16 0
