width 20
height 20
.........@..........
........@...........
...@..........@.....
............@.......
.....@..........@...
....................
...@................
............@...@@..
......@..@.@........
....................
.........@..........
.....@....@...@....@
...................@
..........@.@.@.@...
....@..........@....
.@......@.......@...
.........@@.........
.........@@.@.......
@...@...............
@...................
3
14 16 0
12 4 0
6 17 0

13 18 0
11 4 0
8 6 0
