width 20
height 20
....................
........@..@...@...@
.....@..@@..........
................@...
........@..@........
....@...............
......@.............
@......@...@........
@@.....@@.......@...
@@.......@....@.....
@@.........@.@......
@@....@.............
...@....@.@.........
..@...........@.....
......@...@....@...@
.........@...@@.....
.....@..............
@@......@..@.@......
@@............@.....
@@...@@@@...........
3
12 1 0
7 10 0
0 3 0

9 7 0
0 16 0
8 3 0
