width 20
height 20
....@@@@@...........
.....@@@@@..........
......@@@@..@...@...
........@@@......@..
......@@........@...
.@..................
.........@..@..@...@
..@.................
...................@
.@.................@
....@......@.@......
.........@..........
...............@.@..
..@.....@......@....
.............@....@.
.....@..............
...................@
.........@.........@
............@..@..@@
.........@........@@
3
10 4 0
8 11 0
17 15 0

14 2 0
13 0 0
8 16 0
