width 20
height 20
.........@..........
....................
......@.........@...
........@..@...@....
...@.....@..........
......@......@......
...................@
...................@
.@..@.......@.......
...@.@...@......@@..
..@....@............
.......@............
.@.........@........
.@@@@...@......@....
@@@@@.@....@.@......
@@@@@.......@.......
@@@@....@....@.@....
@@@@................
@@@@....@.......@...
@@..................
3
15 10 0
19 13 0
17 16 0

14 14 0
13 12 0
12 10 0
