width 20
height 20
@...................
@@..................
@@@.@...@.......@...
@.............@.....
....................
........@....@......
.@.......@......@...
.....@........@.....
.@..................
.....@..........@...
...@..@....@..@....@
.....@..@...@.......
..................@.
.........@..@.@.....
@..........@........
@@....@.............
@...................
@...................
....................
.........@.....@....
3
7 2 0
11 16 0
19 11 0

11 7 0
10 6 0
19 11 0
