width 20
height 20
..................@@
.....@....@.......@@
..@...@....@........
....................
.................@..
....@..........@....
......@......@......
....................
.....@........@.....
....................
@@.........@........
@@...@...@.....@....
@@..................
@@.....@............
@@@......@....@@....
@@@................@
@@@......@..........
@@@@....@......@....
@@..........@.......
@@..................
3
4 12 0
0 0 0
13 5 0

13 11 0
6 1 0
3 18 0
