width 20
height 20
....................
..................@.
.........@....@.....
....................
.@............@.....
...........@...@....
@........@..........
@....@@.............
@@..........@..@....
.................@..
....@...@....@......
....................
.......@........@...
..............@.....
...@................
..@..@..............
.................@..
..@...............@.
.........@..@.......
....................
3
1 9 0
15 6 0
3 0 0

17 15 0
15 2 0
10 14 0
