width 20
height 20
@@.................@
@@@.@..@............
@@@.................
..........@.........
.@...@...@..@.......
..@....@.....@.@....
...@.....@..........
.......@......@.....
..@.............@...
......@..@...@......
..........@.....@...
....@............@..
......@.@.........@.
.@....@@.....@......
...@............@...
.................@..
.....@...@.@........
........@...........
....................
@..............@....
3
14 12 0
7 2 0
17 4 0

0 4 0
18 6 0
5 17 0
