width 20
height 20
..........@.........
......@.............
..........@.@.......
...@..@.......@@....
..........@.........
......@..@........@.
..........@.....@@..
.@.......@......@@@.
...@..........@.....
....................
....@.............@.
.@......@....@...@.@
....@..@....@...@..@
........@..........@
...@................
....................
.....@.@..@@........
....................
....................
.........@@@....@@@.
3
18 14 0
11 8 0
2 18 0

0 0 0
4 15 0
19 9 0
