width 20
height 20
@@........@.........
@@...@.....@.@......
@..@...........@....
....................
....@........@......
.......@...@........
..................@.
.......@.........@..
..@..............@..
...@.@.......@.....@
@@......@...........
.................@..
.....@.......@......
............@...@...
.@.@.......@........
....@....@....@.....
........@........@..
@...................
..............@.....
..............@.....
3
14 2 0
1 11 0
2 0 0

1 12 0
2 7 0
1 19 0
