width 20
height 20
..............@@@.@@
..@....@......@@@...
....................
...@...@............
@.................@.
...@..@...@@........
....@..........@.@..
.@......@...........
...........@..@.....
.@...@..........@@..
..........@........@
.....@..............
......@..@....@.....
.......@...@........
................@.@.
....................
....@....@.@..@.....
.@..@....@@.........
...@@@..@@@.........
...@@@.@@@@@........
3
1 2 0
3 11 0
11 15 0

18 12 0
3 10 0
11 15 0
