width 20
height 20
......@............@
...@.@@....@..@.@...
@..............@....
@................@..
@@...@...@......@...
......@....@..@.....
...................@
......@..@...@......
.....@..............
...@...@........@..@
....................
...@.@...@.@........
..@.................
@@.....@............
.........@...@.@....
....................
.......@....@.......
..@..........@......
....................
...........@........
3
2 11 0
10 3 0
0 1 0

13 4 0
9 19 0
6 2 0
