width 20
height 20
@........@@.@.......
@...........@.......
@..@.@............@.
.......@@....@......
.........@.@.....@..
.....@.........@....
...@...@............
.....@...@..@.....@.
.@..................
....@..............@
.....@.@...@..@.....
....................
.....@......@.......
....................
..@...@..@.@........
........@....@...@..
@..@................
..................@.
...@................
....................
3
8 13 0
17 12 0
8 14 0

5 0 0
2 2 0
17 3 0
