width 20
height 20
@...................
...@...@..@....@....
......@.............
...........@........
...............@....
..@............@@...
..............@@@...
...@......@.@.....@.
.....@........@.....
....................
.......@....@......@
.....@..........@..@
..........@.@.......
................@...
...@@........@......
....................
..@....@............
..........@....@....
....................
..........@@@.......
3
13 17 0
13 1 0
13 5 0

12 17 0
4 9 0
12 11 0
