width 20
height 20
....................
....................
...@................
@.........@....@....
.....@..............
......@...........@.
..@.........@.......
@.........@.....@...
.............@......
...........@.....@..
.....@..............
.............@...@..
....................
.......@.....@......
...@...........@....
.................@..
.......@...........@
...........@........
...@................
@...@...........@...
3
8 7 0
13 5 0
5 15 0

18 15 0
1 14 0
15 17 0
