width 20
height 20
@...................
@....@..@...........
.............@......
....................
....@.......@.......
..........@......@..
......@.......@.....
........@......@....
....................
....@....@..@...@@@@
....................
@..........@..@.....
....@.@..@..@.......
...........@...@....
@................@@.
@.....@.............
..........@.@.......
....................
@@..........@.......
@@............@.....
7
3 14 0
15 18 0
13 9 0
11 9 0
18 5 0
11 3 0
5 4 0

18 17 0
16 19 0
14 9 0
1 0 0
15 0 0
11 3 0
15 16 0
