width 20
height 20
............@.......
....................
....................
...@........@..@....
........@.@......@..
...@.....@........@@
....................
....@...............
...@...@....@......@
......@........@....
.@@.....@...@.......
.............@......
....@....@..........
.....@..............
......@....@........
..@.......@..@...@..
......@......@......
...............@....
...@................
....................
7
13 7 0
17 7 0
13 5 0
1 9 0
10 13 0
17 9 0
18 12 0

10 14 0
17 1 0
13 10 0
3 15 0
9 13 0
13 9 0
3 1 0
