width 20
height 20
@@@..@..............
@..@....@.....@..@..
..........@..@@....@
.....@..@....@@.....
............@...@...
.@..................
...@................
...............@....
.......@.@.@.@......
....................
..........@.....@...
....@.@.@..@........
...............@....
...@...............@
........@..........@
..........@.....@...
.......@....@.@.....
........@..@......@.
................@...
....................
7
11 6 0
1 6 0
2 7 0
11 7 0
10 7 0
11 3 0
15 19 0

17 8 0
4 12 0
16 0 0
11 7 0
15 6 0
7 13 0
5 17 0
