width 20
height 20
@....@@@@..........@
.....@@@..@@@@@.....
............@@..@...
............@@......
....@...............
........@....@..@...
...............@....
@...................
....@.......@..@....
................@...
...@................
............@.......
........@.@.........
.......@.....@......
....@.....@.........
...@..@..@....@...@.
........@...........
..................@.
..@@.............@..
..........@@@......@
7
1 14 0
12 13 0
0 6 0
15 1 0
16 16 0
11 4 0
0 14 0

4 10 0
18 8 0
11 11 0
11 7 0
0 1 0
0 19 0
14 5 0
