width 20
height 20
...............@....
....................
...@..........@.....
...............@....
.....@..........@.@.
..@.........@.......
..........@.........
...........@....@...
...@..@.@.@.........
............@.......
....@...........@..@
.....@..@.....@.....
....................
...@.@.....@...@....
@@..................
...........@........
......@.............
....................
...@................
..................@@
7
8 14 0
18 18 0
14 9 0
8 6 0
3 1 0
1 8 0
11 2 0

16 5 0
7 8 0
7 13 0
5 12 0
10 1 0
16 8 0
18 8 0
