width 20
height 20
....................
...........@....@...
.......@@...........
...................@
......@......@..@...
....................
..@..........@......
@..........@........
@@..................
@@..............@...
....@.@....@...@....
.....@...........@..
.@..............@@..
.....@..............
.......@.....@......
.@.......@.@....@...
@@..@...............
@@@..@..@...........
@@..................
@@@@................
7
14 9 0
3 11 0
12 3 0
6 18 0
14 11 0
19 19 0
5 3 0

4 1 0
17 9 0
14 9 0
19 5 0
5 0 0
10 0 0
9 7 0
