width 20
height 20
@.....@.............
@...................
.......@............
......@@@......@....
....@...@...........
..................@.
.............@..@...
....................
...@..@@............
...........@.....@..
.@..................
...@...@........@...
......@.......@.....
...........@........
..............@.....
@..@..............@@
..........@..@...@@@
................@@@@
................@@@@
...............@@@@@
7
14 6 0
7 5 0
0 11 0
11 17 0
15 17 0
10 8 0
17 1 0

1 16 0
19 14 0
18 0 0
1 9 0
4 1 0
11 16 0
7 0 0
