width 20
height 20
....................
....................
..@..@.........@....
.............@.....@
....@.........@..@.@
............@.......
..@..@..............
...@....@...........
..@..@......@.......
........@.@...@.....
...@................
................@...
@...................
....................
..@.......@...@.@...
...........@.......@
.@..............@...
....@..@...@........
..........@....@....
.....@@.@...@.......
7
3 12 0
2 11 0
1 18 0
17 15 0
17 6 0
6 12 0
14 12 0

8 16 0
18 4 0
18 0 0
1 12 0
18 1 0
3 4 0
1 2 0
