width 20
height 20
..........@@@......@
....@..............@
...................@
.........@........@.
...@.......@........
......@.....@...@...
.........@....@.....
...@................
.................@..
.......@............
@...@...............
@.........@.@.......
@...................
..@.@...........@...
....................
......@.............
.................@.@
..........@.@.......
..................@@
..................@@
7
12 8 0
9 2 0
2 6 0
5 10 0
9 13 0
5 3 0
14 8 0

0 17 0
18 14 0
3 10 0
9 4 0
18 0 0
19 13 0
14 13 0
