width 20
height 20
......@..........@@@
...............@....
.............@......
@...................
..............@..@..
....@..@..@.........
....................
....................
..@...@....@........
.@............@.....
........@...@.......
...@......@.........
..@............@....
....................
..@.................
................@...
......@.....@.....@.
.................@..
....@@..............
@..@@..............@
7
18 8 0
3 6 0
5 1 0
16 2 0
5 6 0
15 8 0
15 14 0

1 19 0
3 6 0
14 16 0
15 0 0
16 18 0
8 16 0
6 3 0
