width 20
height 20
....................
...........@......@.
.......@....@.......
...@...@...@..@.....
........@...........
..@..........@@.....
...........@...@...@
@......@...........@
@.....@.........@...
..........@.........
....................
..@...@.............
..........@........@
.......@..........@@
....................
.....@.....@....@...
..@.........@.......
.@......@@...@......
........@.......@..@
...................@
7
11 13 0
14 8 0
0 12 0
3 14 0
19 16 0
4 13 0
6 12 0

0 2 0
13 13 0
14 4 0
9 0 0
5 11 0
19 10 0
15 10 0
