width 20
height 20
@@@.................
@...........@.@.....
.........@..........
....................
..............@.....
...............@.@..
..@.@.@.........@...
.......@.....@......
...........@...@....
.@....@..@..........
.@.........@......@.
.....@...@...@......
...@........@.....@.
.......@...........@
..............@...@@
.....@...@..@.......
...@..........@@.@..
..........@..@......
....................
............@@......
7
8 10 0
9 17 0
18 4 0
0 7 0
17 11 0
8 17 0
3 17 0

8 9 0
9 8 0
0 18 0
2 1 0
0 3 0
18 0 0
19 0 0
