width 20
height 20
...........@......@.
.......@...@......@.
......@.............
@.@@..@...@..@...@..
@....@..............
............@.@..@..
....................
......@......@..@..@
.........@.....@...@
......@............@
....................
..@..@....@.........
....................
........@.....@...@.
.....@..............
.....@.......@......
....................
.....@.@.....@.@....
.....@..............
.....@@........@@...
7
11 10 0
13 16 0
17 0 0
4 12 0
15 6 0
4 9 0
10 4 0

1 19 0
10 16 0
11 2 0
11 10 0
0 9 0
15 11 0
15 14 0
