width 20
height 20
....@...............
.......@............
..@......@..........
...@.......@...@.@..
....................
.........@@....@@...
..@@............@...
..................@.
.............@..@...
........@..@......@.
....................
....................
.............@......
..@....@...........@
....@...@..@........
.........@..........
.....@......@.......
...............@....
....................
........@.......@@..
14
12 12 0
18 16 0
19 12 0
8 16 0
7 5 0
10 18 0
15 12 0
19 0 0
7 14 0
7 16 0
5 3 0
1 4 0
0 9 0
11 13 0

14 8 0
3 14 0
2 1 0
0 5 0
17 0 0
4 11 0
19 5 0
16 11 0
5 5 0
12 1 0
17 12 0
17 16 0
14 3 0
7 10 0
