width 20
height 20
............@.......
..............@.....
................@...
....@......@........
..@.....@@.........@
....@...@@..........
.............@.....@
....@...............
....................
.........@...@......
.@..@......@..@..@..
..@.................
...............@..@@
...@......@.........
..@....@....@.@.....
.@.@..@@.........@..
....@@@...@........@
.....@......@......@
................@..@
..................@@
14
14 13 0
10 4 0
3 18 0
2 3 0
13 5 0
7 0 0
7 6 0
19 0 0
19 3 0
5 6 0
18 3 0
16 19 0
8 3 0
5 7 0

0 5 0
12 16 0
8 19 0
13 14 0
7 19 0
6 17 0
17 19 0
6 9 0
17 1 0
5 6 0
2 9 0
10 19 0
1 19 0
17 6 0
