width 20
height 20
.....@...@@@........
..@.................
....................
...@...@............
.......@@...........
.........@....@.....
.............@.@.@..
......@@@@.@........
........@........@..
.........@..@.@.....
..................@.
.......@............
...@...@...@.@......
............@.@.....
....................
.@............@.....
...@.@...@.....@....
.@.........@..@.....
....................
.........@@.........
14
19 1 0
2 2 0
5 2 0
12 0 0
0 18 0
13 13 0
12 7 0
18 6 0
12 11 0
5 5 0
16 6 0
10 16 0
7 9 0
14 2 0

5 14 0
11 14 0
19 8 0
3 9 0
8 18 0
0 10 0
3 7 0
19 0 0
0 18 0
0 1 0
0 19 0
17 13 0
4 8 0
6 19 0
