width 20
height 20
@....@........@@@...
@.............@@@...
...........@...@@...
..@......@..........
......@.......@....@
............@..@....
...@...............@
.......@.@.@...@....
@..@.@..............
@.............@.....
@.......@.@.........
.............@......
...@................
..@....@............
.@...@..............
.@......@....@......
...@.......@........
...............@....
@@@..@..........@...
@@@@...............@
14
13 6 0
10 7 0
5 16 0
10 3 0
10 2 0
0 12 0
19 17 0
11 19 0
18 5 0
11 17 0
8 3 0
6 12 0
8 14 0
15 9 0

4 18 0
17 19 0
19 3 0
16 4 0
8 3 0
0 11 0
18 18 0
15 18 0
1 13 0
2 4 0
10 1 0
3 11 0
13 8 0
6 15 0
