width 20
height 20
............@@....@@
...................@
......@.............
............@.......
....................
@..@.@.....@.@.@....
@@..@...............
.......@.@..........
..............@.....
.@....@...@......@..
.....@..@..@........
..@.........@.@.....
....................
........@.@.@.@.....
..@................@
...........@.....@..
..@......@..........
.......@............
....................
...................@
14
7 3 0
19 10 0
17 3 0
3 15 0
5 6 0
10 12 0
6 16 0
12 15 0
18 3 0
5 14 0
18 10 0
13 17 0
3 0 0
1 1 0

7 6 0
8 5 0
2 19 0
3 15 0
0 14 0
18 18 0
3 18 0
0 0 0
5 8 0
10 16 0
16 9 0
1 2 0
18 16 0
3 1 0
