width 20
height 20
.......@@..........@
........@...........
....................
...............@....
............@.@.....
........@...........
..@.........@...@...
..............@.....
.....@..........@...
.......@............
...@.......@........
.....@....@.........
....................
@..@................
@..........@........
@.........@.....@@..
...............@....
.....@..@.......@...
......@.............
...........@...@....
14
1 4 0
15 7 0
2 4 0
1 13 0
19 17 0
1 0 0
7 4 0
5 15 0
16 10 0
1 11 0
8 4 0
3 14 0
7 10 0
8 9 0

17 18 0
14 9 0
2 11 0
8 8 0
13 16 0
2 8 0
3 16 0
14 13 0
11 17 0
11 15 0
6 19 0
15 0 0
14 3 0
18 1 0
