width 20
height 20
@@......@@@.......@@
.......@@@@.........
....@.......@...@...
.............@......
.......@............
....................
......@....@...@@...
..@....@......@@.@..
............@.......
....@...............
.@...@.@............
..........@.....@...
.........@..@.......
...@....@......@....
.@..................
.................@..
...@..@.........@...
...........@........
....................
...@................
14
0 11 0
6 11 0
16 8 0
19 8 0
13 4 0
14 6 0
18 9 0
9 3 0
3 12 0
6 19 0
4 17 0
12 16 0
13 6 0
5 12 0

5 11 0
6 10 0
0 9 0
4 19 0
4 7 0
0 15 0
3 10 0
4 10 0
5 17 0
16 3 0
6 17 0
11 19 0
4 18 0
17 2 0
