width 20
height 20
........@@@@@.......
........@@@@@.......
......@..@@@@...@.@.
...@.......@@.......
....................
...........@...@....
..@......@......@...
.............@......
......@.............
......@..........@..
...@..........@.....
@@@@@@.....@...@....
@@@@@@@......@......
@@@@@@@@............
@@@@@@@@....@..@.@..
@@@@@@@@..@.........
@@@@@@@......@......
@@@@@@@.............
@@@@@@@...........@.
@@@@@@@............@
14
0 6 0
9 17 0
17 16 0
16 9 0
18 13 0
11 12 0
12 19 0
5 0 0
16 4 0
9 4 0
17 7 0
4 2 0
8 8 0
1 8 0

18 4 0
12 16 0
9 11 0
7 1 0
17 12 0
0 0 0
17 3 0
6 3 0
18 11 0
14 17 0
17 6 0
8 10 0
10 5 0
19 18 0
