width 20
height 20
...................@
..................@.
..............@.....
.........@..........
...@..@....@....@...
.............@......
.@......@.....@.....
..........@....@....
...@.........@......
.......@...@........
....................
...@.........@.@....
....................
....@...............
......@......@.....@
.......@...........@
....@@...........@..
@.@...@....@....@...
@...................
@@@...........@.....
14
10 5 0
11 13 0
13 10 0
8 2 0
0 2 0
12 18 0
14 8 0
7 17 0
12 1 0
6 11 0
1 7 0
16 15 0
13 12 0
19 3 0

0 12 0
2 8 0
18 15 0
12 0 0
0 8 0
13 16 0
5 11 0
5 2 0
14 3 0
15 17 0
19 3 0
0 0 0
15 14 0
16 3 0
