width 20
height 20
@......@..@.......@@
.......@.@@.......@@
....................
...................@
....@......@.....@..
............@.......
...@.@..............
...........@....@...
..........@.........
..@.................
....................
......@....@......@.
..............@.....
.@..@............@..
.....@..............
.@..........@..@.@.@
..@....@..@........@
.............@......
......@........@....
....................
14
7 7 0
5 9 0
3 17 0
5 19 0
8 16 0
6 2 0
8 19 0
10 14 0
17 6 0
1 0 0
13 8 0
11 2 0
12 4 0
8 18 0

19 19 0
13 0 0
6 12 0
1 14 0
17 12 0
15 17 0
3 10 0
9 6 0
6 6 0
18 16 0
4 16 0
18 18 0
3 13 0
13 19 0
