width 20
height 20
...................@
....................
....@...@...@...@...
...@................
.......@.@........@.
....................
............@@......
.........@........@.
.....@@..........@..
...........@..@.@...
.............@......
........@.....@..@..
...@...........@....
..........@.........
..@....@....@..@....
..............@..@..
...........@........
..@............@....
....@..............@
............@.......
14
2 12 0
13 3 0
17 18 0
10 8 0
12 11 0
13 16 0
12 7 0
3 1 0
2 5 0
19 9 0
8 17 0
18 10 0
5 16 0
17 6 0

4 3 0
3 17 0
10 0 0
0 19 0
5 3 0
14 18 0
1 19 0
4 4 0
9 9 0
11 6 0
10 12 0
19 8 0
9 13 0
13 5 0
