width 20
height 20
......@@.....@......
@..................@
.........@..........
.@..............@...
....@@............@.
..........@.@.......
...@.....@.@........
.....@..@.....@.@...
@........@..........
@...............@...
@...@......@........
.......@..........@.
@.@...........@.....
@@..........@.......
....................
.@..................
....@..@.........@..
........@...........
....................
.......@............
14
1 7 0
2 13 0
14 8 0
8 18 0
14 0 0
15 17 0
10 9 0
19 9 0
8 5 0
9 12 0
4 3 0
15 19 0
2 19 0
18 0 0

17 17 0
17 6 0
9 0 0
7 6 0
1 18 0
8 16 0
10 7 0
18 5 0
5 18 0
1 5 0
6 16 0
11 13 0
4 13 0
0 17 0
