width 20
height 20
.............@......
...@.........@......
.............@..@...
...............@....
.@.......@..........
..............@.....
........@...........
..@...........@.@...
......@.............
....@...............
@@..................
@@............@.....
......@...@...@.....
@.................@.
@...................
............@..@....
...@..@.@........@..
..........@.........
................@...
....................
14
12 13 0
8 12 0
19 13 0
19 18 0
10 5 0
14 19 0
2 8 0
10 2 0
9 16 0
13 17 0
16 13 0
15 9 0
3 0 0
9 18 0

1 0 0
16 4 0
5 5 0
19 14 0
4 11 0
1 9 0
2 8 0
2 16 0
14 2 0
6 6 0
9 11 0
15 8 0
0 0 0
8 2 0
