width 20
height 20
....................
@@..................
@@...@..............
...@...@.........@..
..@.................
...........@@.@.....
..@........@@.......
.......@............
..........@.......@.
...@@.......@...@...
.......@.@.@.....@..
......@.....@...@...
....................
................@...
.......@............
...@.........@......
........@.........@.
....................
..........@..@......
...@...............@
14
18 19 0
6 0 0
6 19 0
10 9 0
5 9 0
6 2 0
17 11 0
16 1 0
3 17 0
12 16 0
13 7 0
16 15 0
1 12 0
17 6 0

18 18 0
5 3 0
4 1 0
3 2 0
5 9 0
17 18 0
18 14 0
0 18 0
0 13 0
13 0 0
3 17 0
4 18 0
18 0 0
7 16 0
