width 20
height 20
...............@@@..
..........@.@.......
......@.............
....................
....................
...@...........@....
.@...@...@..@.......
...............@....
........@...........
.......@.....@......
............@.......
...@................
......@..........@..
..........@...@.@...
...........@........
..@...@...........@@
...@..............@@
...........@......@@
..................@@
..................@@
14
10 19 0
4 18 0
17 18 0
15 1 0
15 16 0
14 2 0
13 7 0
7 2 0
4 4 0
17 4 0
0 1 0
3 6 0
1 15 0
13 13 0

8 10 0
5 14 0
5 4 0
0 15 0
9 14 0
1 9 0
16 10 0
9 2 0
19 1 0
3 12 0
1 15 0
12 19 0
13 3 0
5 0 0
