width 20
height 20
@@@.................
.........@..........
..@.................
.....@.@..@.........
......@..@.@..@.....
....................
...@......@.....@...
........@....@......
.....@........@.....
..........@....@....
....................
.@..........@..@....
...@................
..........@....@....
....@..@.....@......
................@...
.@..@...............
...........@.....@..
............@..@....
.....@@.............
14
9 5 0
7 16 0
8 17 0
16 11 0
13 10 0
19 16 0
15 12 0
0 1 0
14 13 0
16 0 0
5 6 0
1 18 0
11 9 0
4 13 0

6 18 0
19 5 0
1 17 0
3 10 0
16 8 0
7 13 0
5 9 0
8 1 0
11 10 0
2 12 0
6 0 0
10 8 0
14 2 0
5 13 0
