width 20
height 20
@@.@................
................@...
.@..........@....@..
......@.............
........@.....@.....
.........@..........
.....@..............
..........@.....@...
...................@
....@...............
.@.............@....
.......@.@......@...
............@@@.....
.@@.@...............
..@..............@.@
..@................@
......@..@.@...@.@.@
@......@...........@
....................
...........@........
14
15 19 0
1 16 0
1 15 0
0 13 0
4 6 0
14 16 0
4 3 0
11 18 0
3 12 0
17 11 0
12 3 0
7 12 0
0 10 0
11 13 0

15 14 0
19 0 0
10 4 0
14 3 0
1 18 0
11 8 0
14 0 0
18 18 0
19 1 0
17 19 0
18 11 0
4 10 0
10 1 0
12 6 0
