width 20
height 20
.............@..@@@@
.@@...............@@
....................
.........@.........@
.......@.......@..@@
..................@@
.....@.@.....@......
....................
..@...@......@.@....
.............@......
...@..........@.....
.....@..............
....@...............
....................
...........@.@..@@..
......@.......@.....
..........@.@.......
@@@...@..........@..
@...................
.....@@......@......
14
12 14 0
3 8 0
18 17 0
7 7 0
4 9 0
14 11 0
14 9 0
9 18 0
6 1 0
6 11 0
3 4 0
18 16 0
4 3 0
13 5 0

1 14 0
8 9 0
13 18 0
12 4 0
16 18 0
0 4 0
3 11 0
0 0 0
15 10 0
10 5 0
4 11 0
14 6 0
12 19 0
8 1 0
