width 20
height 20
......@......@......
....@...............
............@.......
....@........@......
.....@.......@@@....
........@........@..
....@....@.@..@.....
...@................
........@......@....
.............@......
..@......@..........
..............@.....
......@...........@.
............@..@....
........@....@......
..@...@...........@@
..............@...@@
.........@.......@@@
............@....@@@
@@........@.....@@@@
14
1 11 0
13 13 0
13 11 0
2 9 0
11 14 0
11 10 0
7 6 0
8 11 0
4 7 0
13 18 0
3 3 0
12 8 0
7 12 0
17 4 0

1 11 0
5 6 0
6 2 0
2 6 0
6 5 0
0 16 0
15 7 0
9 13 0
10 18 0
5 3 0
2 3 0
2 19 0
2 9 0
17 4 0
