width 20
height 20
@@@@@...............
@@@@................
@@@@...........@....
..@@....@...@.@.....
@..@................
@@......@........@..
@....@..............
.......@.@.....@.@..
....................
.....@.....@........
....................
............@..@....
..@@................
.....@...@..@.......
.@@.................
..@..@.@..@.@.......
..@.................
...............@....
................@..@
....................
4
18 3 0
13 12 0
4 13 0
1 18 0

9 16 0
13 11 0
10 18 0
19 1 0
