width 20
height 20
.@..................
.@......@...........
....@..........@....
.......@............
...@................
.............@.@....
........@...........
....................
.....@.............@
..........@.@......@
....@..............@
............@....@..
.......@.....@......
.........@.........@
...@.@...........@@@
.............@..@@@@
................@@@@
.......@........@@@@
.@......@......@@@@@
...............@@@@@
4
8 13 0
16 11 0
0 8 0
15 11 0

0 8 0
17 12 0
10 5 0
4 17 0
