width 20
height 20
@@@@.......@........
@@@...@.............
@@...@.......@......
@@.....@...@........
....................
...............@....
.@...@..@..@........
................@...
..@.....@....@......
....................
.........@.....@....
.......@.........@..
........@...@..@....
....................
..........@....@..@.
......@.............
..@...........@.....
....................
....................
.........@......@@..
4
6 6 0
5 19 0
5 15 0
3 13 0

4 15 0
18 2 0
18 9 0
10 10 0
