width 20
height 20
@@@@@@@@@@@@........
@@@@@@@@@@..........
@@@@@@@@............
@@@@@@@.........@...
@@@@@@@..@.@..@....@
@@@.....@....@...@@@
@....@...........@@@
@@..........@..@....
.....@..@...........
......@...@....@....
.@..@......@..@.....
....................
......@..@.......@..
............@.......
....@..@.......@....
...@................
.............@......
....................
@........@..........
@@...@@@......@.....
4
11 18 0
1 18 0
17 3 0
8 4 0

13 0 0
8 10 0
12 11 0
7 5 0
