width 20
height 20
......@.............
@....@..............
....................
....................
...@..@.........@...
....................
.@........@...@.....
....................
.....@.....@@@....@.
......@.............
.......@.@.@........
..........@.........
........@...........
...............@....
.@............@.....
....................
.......@....@.......
....@@..@.@.........
...@@@..........@...
...@@@..........@@..
4
9 7 0
16 9 0
10 8 0
1 7 0

7 8 0
1 16 0
8 0 0
1 3 0
