width 20
height 20
...................@
........@.......@...
.@..@...............
....................
........@.........@.
..@...@.............
....@.........@.....
......@...@....@....
.........@..@.......
....................
@.....@.............
....................
.....@..@...........
...@.........@.@....
....@...............
.....@....@.@....@..
.@......@....@......
.......@.......@....
.................@..
....................
4
7 5 0
12 1 0
10 1 0
3 5 0

12 12 0
13 18 0
19 17 0
19 12 0
