width 20
height 20
....................
....................
....................
...@................
..........@...@.....
......@.............
...@......@.........
.........@....@.@...
...@....@...........
..............@.....
.................@..
....................
@..........@........
......@@............
...........@........
.@.................@
......@.@..........@
.............@....@.
...............@....
..............@@....
4
12 4 0
13 14 0
2 5 0
4 1 0

1 13 0
13 14 0
13 18 0
19 14 0
