width 20
height 20
....................
.@...@..............
.......@............
.@........@..@......
................@...
....................
.............@..@...
.....@.@.@.....@....
....@.....@..@......
...........@......@.
....@........@...@..
@@.....@....@.......
@@...........@......
@@........@.........
......@.........@...
.........@...@.@..@.
......@.............
..........@..@......
.@....@.........@...
...................@
4
5 3 0
17 1 0
18 0 0
14 0 0

13 0 0
0 3 0
16 7 0
16 11 0
