width 20
height 20
....@...............
.@....@......@......
.........@..........
....................
....................
.....@.@............
...@....@...........
.@...........@......
.@...............@..
....@......@........
@@........@.........
..................@.
...@.............@..
....................
...........@........
....@.....@@@.......
..@..@.....@@.....@@
............@....@@@
....@.@.@@.........@
........@...........
4
7 17 0
4 11 0
2 1 0
6 10 0

18 1 0
16 4 0
19 15 0
3 9 0
