width 20
height 20
........@...........
...@......@.....@.@.
.....@.@............
...@.........@....@.
.......@...@........
...@.....@..........
@@..................
@.....@..@....@.....
..........@.........
..@............@....
.....@.......@......
.........@..........
...@.@.@......@.....
.............@......
............@.......
.......@............
.....@.........@....
......@..........@..
...@.........@......
..@@................
4
7 9 0
14 2 0
14 11 0
5 3 0

18 5 0
10 11 0
1 4 0
18 9 0
