width 20
height 20
....................
...........@..@..@..
@.......@@.....@...@
....@......@....@..@
.......@...........@
...@...............@
.....@.@....@.@.....
..@.@........@......
.................@..
.......@............
.....@...@.........@
...@...@...........@
............@.@....@
................@..@
......@.............
.................@..
....@.......@..@....
...@...@............
....................
......@.............
4
0 7 0
1 0 0
7 16 0
13 0 0

19 17 0
18 11 0
15 1 0
4 9 0
