width 20
height 20
@.@.@@..............
..@.................
....................
.@..................
..@...........@.....
.....@..@..@........
...............@....
.......@.@.@......@@
..@..@............@@
............@.@....@
...@.@.@...@...@....
.................@..
...@.@.....@........
...............@....
..............@.....
............@.@.....
.............@@@....
....................
.........@....@.....
@...@..........@@...
4
8 11 0
17 7 0
5 13 0
11 2 0

5 1 0
18 12 0
13 0 0
18 3 0
