width 20
height 20
.......@...@@@......
................@...
.....@..............
...........@........
.........@..........
..................@.
......@........@....
.......@............
......@.@........@..
..@.........@.......
....@..........@....
........@...........
@..@..@...........@.
.............@......
.............@......
........@...........
................@...
....@...............
............@......@
...................@
4
11 5 0
4 13 0
0 3 0
1 18 0

2 7 0
5 6 0
7 18 0
15 15 0
