width 20
height 20
.@@.@@..............
...................@
....@..@.@.........@
....................
............@.......
......@.@...@.....@.
...@..........@.@...
.........@..........
......@......@......
...@......@.........
......@.....@.......
..@........@.@......
...@...............@
..............@....@
..........@........@
...............@....
.....@.........@....
..............@.@...
..@.......@.........
@...................
4
12 18 0
8 7 0
1 10 0
0 8 0

14 9 0
8 12 0
18 0 0
19 15 0
