width 20
height 20
....................
....................
...........@........
...@.@..............
.@............@.....
..........@.....@...
....@...@...........
..............@...@.
........@...........
..................@.
.....@...@..@.......
...........@....@...
....@............@..
.....@........@.....
....................
.......@.@.@........
.................@..
..@..@......@@@.....
.............@@....@
@@........@..@.....@
4
7 16 0
10 13 0
17 6 0
12 11 0

8 4 0
3 1 0
0 10 0
7 8 0
