width 20
height 20
....................
.......@..........@.
....@...............
......@..........@..
.........@..........
@@....@@..@.........
@@...............@..
@....@..............
@...................
@.......@..@....@...
....................
....................
........@...........
.....@..............
........@..@......@@
.....@...@..@.@...@@
.............@...@.@
........@..........@
..........@...@.....
.....@@.............
4
5 12 0
11 17 0
11 11 0
7 3 0

0 17 0
18 2 0
14 16 0
6 17 0
