width 20
height 20
....................
....................
@......@..@......@..
.....@.....@..@.....
....................
...@.@....@.@.......
@...................
......@.....@.@.....
................@...
.@.....@............
....@.......@.......
.........@..........
.....@..@.........@.
@.....@..........@..
@..........@..@.@...
.....@..............
................@...
....................
..@..............@..
..............@.....
4
3 17 0
12 19 0
3 18 0
4 7 0

19 3 0
10 10 0
8 19 0
16 17 0
