width 20
height 20
....................
........@...........
.......@......@@....
....................
....@......@........
@.......@.........@.
...@................
.......@............
@.........@........@
.....@.@........@..@
....@.......@.......
...........@.@......
..@...........@.@...
...........@.......@
......@.....@....@@@
.....@..............
............@......@
...@....@...........
...........@...@....
@...................
7
7 0 0
17 16 0
13 0 0
14 18 1
15 1 1
7 10 2
9 17 2

12 19 0
0 10 0
14 10 0
12 13 1
1 1 1
6 13 2
19 0 2
