width 20
height 20
..............@@....
.......@............
....................
...@....@.@..@......
.....@..............
.........@..........
...............@....
...@.............@..
.......@............
............@....@..
...@................
...........@....@...
..@...@......@.@....
............@......@
...@.....@.........@
.............@.....@
..@.......@.........
............@...@...
....................
@........@..........
7
11 14 0
13 6 0
19 0 0
11 13 1
10 17 1
10 8 2
0 7 2

5 2 0
4 19 0
1 16 0
4 18 1
9 3 1
1 19 2
19 19 2
