width 20
height 20
..................@@
..................@@
...@.....@........@@
..@...@........@....
........@...........
.....@......@...@...
..@...........@.....
.......@@@@@........
...@...@@@@.........
...........@........
....................
@........@......@...
...@........@.......
........@....@...@..
....@..@............
............@....@@.
....@....@...@....@.
@...................
..@.................
....................
7
16 8 0
8 5 0
12 18 0
5 11 1
14 19 1
15 11 2
3 13 2

3 7 0
15 12 0
9 6 0
12 9 1
0 0 1
17 16 2
18 3 2
