width 20
height 20
....................
....................
............@.......
..............@.@...
....@...............
......@.............
..........@.@.......
..@.................
.......@..........@.
....@.....@....@....
.....@.........@....
......@..@...@....@.
@..@....@...........
......@......@...@..
............@.......
....................
...........@..@.@...
....@.@.@....@......
.....@..............
....................
7
2 4 0
2 18 0
12 11 0
10 19 1
1 19 1
14 15 2
5 8 2

5 12 0
18 10 0
5 6 0
18 2 1
17 11 1
15 15 2
16 17 2
