width 20
height 20
...@................
..................@.
.......@............
....@.........@..@..
........@...........
............@.@.....
.........@......@.@@
....................
...@.........@.....@
.....@...@.........@
.......@....@.......
...........@........
.....@...@.......@..
..@...@.......@...@.
....................
.....@..@........@..
@@...........@...@@.
.@..@......@........
....................
@@.@.......@........
7
15 17 0
0 15 0
12 17 0
5 19 1
9 13 1
11 16 2
2 2 2

17 13 0
17 4 0
13 9 0
19 2 1
3 15 1
16 16 2
19 14 2
