width 20
height 20
....................
.................@..
.............@......
.........@..@...@...
......@...@.........
...@................
................@...
.@.....@.........@..
....................
.........@..........
@....@....@.........
................@...
...@..@..@.....@....
....................
......@..........@..
..........@..@......
....@...............
......@.............
..........@@@@@.....
....@.....@@@@@@@...
7
14 8 0
18 0 0
7 14 0
2 8 1
13 10 1
6 0 2
12 7 2

14 8 0
2 0 0
15 5 0
2 8 1
0 18 1
16 13 2
6 6 2
