width 20
height 20
............@@@.....
.................@..
@...........@.......
....................
....@....@..........
....................
..@........@........
.............@......
.....@..@.......@@..
..@........@........
.@.............@.@..
....@@..............
........@.@........@
...............@...@
....@..............@
....................
@..@....@....@..@...
@...@.@.....@.......
...................@
..@.@.@@.........@@@
7
15 14 0
6 6 0
5 17 0
1 4 1
8 10 1
12 18 2
18 17 2

0 6 0
11 2 0
14 1 0
0 10 1
10 3 1
13 18 2
1 1 2
