width 20
height 20
....................
..................@.
....@.......@.@.....
....................
.........@..........
................@...
.............@.@...@
.@...@..@...@.......
..........@.........
..@.@..........@....
......@..@..........
.......@...........@
....@......@.......@
....................
.....@...@..@..@....
...@.......@.@......
.@.....@............
..............@@@...
..........@...@@....
...........@..@@..@@
7
15 15 0
6 11 0
15 5 0
2 12 1
1 5 1
3 9 2
1 9 2

16 9 0
14 5 0
19 15 0
17 11 1
15 0 1
13 8 2
13 16 2
