width 20
height 20
...........@@@......
....@...............
.............@......
....................
..........@.........
....@.@......@......
....@@@@............
................@.@.
....................
.....@......@.@...@.
........@...........
......@...@.........
.............@...@..
....@...............
....................
........@..@@.......
...........@........
......@.............
....................
...@.........@....@@
7
5 5 0
19 9 0
14 6 0
15 0 1
17 4 1
16 0 2
16 16 2

5 10 0
10 5 0
1 14 0
9 8 1
16 13 1
1 15 2
15 19 2
