width 20
height 20
...@....@@.........@
.........@..........
.@.....@......@.....
......@.............
@.............@..@..
............@.......
....@...............
..@...@.............
.@.........@........
....................
.....@..........@...
......@......@@.....
....@......@........
......@.............
...@........@....@@@
@..............@.@@@
.@......@........@@@
................@@@@
........@.......@@@@
...............@@@@@
7
17 8 0
9 7 0
12 17 0
8 1 1
1 9 1
15 2 2
11 3 2

10 10 0
13 4 0
8 11 0
10 18 1
4 19 1
5 17 2
1 17 2
