width 20
height 20
.............@@@@@@@
.@........@...@@.@@@
.................@@@
.................@..
.....@.....@........
..............@.....
....................
....@.....@..@......
.@.................@
......@.............
.@.......@....@.....
..@...@.@...........
............@.......
.......@..........@.
....@...@.....@.....
.................@..
...@@.....@.@...@.@.
....................
.......@......@...@.
...................@
7
14 7 0
10 3 0
1 9 0
7 12 1
6 2 1
13 17 2
2 12 2

14 6 0
18 15 0
2 9 0
16 1 1
8 3 1
13 17 2
2 12 2
