width 20
height 20
....................
........@......@....
....................
...............@.@..
.@....@......@......
................@...
.........@.@.@....@.
...@@.......@.......
...@....@.........@.
....................
...@...........@....
..............@.....
.........@..........
..........@....@....
.........@......@...
...@..............@.
............@.......
.............@...@..
@@@.................
@@@@@@@@@@@.....@@@@
7
19 10 0
10 12 0
14 5 0
17 11 1
9 13 1
11 16 2
2 15 2

19 16 0
11 14 0
5 2 0
16 3 1
16 8 1
11 17 2
5 5 2
