width 20
height 20
..........@.........
.............@......
...@................
.......@.....@......
..@.@...............
.............@......
...........@..@.....
......@..........@..
...@........@..@....
....................
.@...........@..@...
.....@.@.@.@........
......@.........@@@@
.........@......@...
..............@.....
@@.........@.@......
@@....@.........@...
@@.......@.......@..
.............@......
....@...............
7
0 3 0
11 19 0
11 2 0
12 10 1
14 13 1
16 8 2
10 10 2

15 7 0
5 0 0
8 8 0
1 2 1
0 14 1
18 5 2
10 8 2
