width 20
height 20
....................
....@...@.........@.
..@.................
.............@.@....
....@......@..@.....
..@......@..........
.......@..........@.
..@...@.@.@..@..@...
....................
@.....@.....@....@..
..............@.....
.............@......
..@..@..@...........
........@@.@.......@
........@..........@
.....@.....@..@.....
.......@........@...
....................
..@..........@.@.@..
...@@@@@@..........@
7
17 19 0
12 0 0
3 2 0
15 9 1
6 6 1
4 16 2
17 13 2

18 2 0
2 10 0
7 4 0
3 8 1
13 17 1
13 16 2
11 19 2
