width 20
height 20
@.................@@
@...........@..@....
@.....@.............
@..@..........@.....
........@......@...@
................@..@
.@...........@.....@
.......@....@......@
.....@..........@.@@
..@.....@...........
....@...............
............@.@.@...
..@.....@...........
.....@..............
..........@.........
............@..@...@
.......@......@..@..
....@.....@.........
...@@........@@.....
...@@@.......@@@@...
7
11 15 0
17 1 0
12 6 0
6 8 1
10 11 1
13 11 2
18 10 2

2 8 0
9 8 0
15 13 0
16 0 1
19 17 1
9 12 2
10 0 2
