width 20
height 20
....@@.......@......
..@.................
....................
......@.........@...
.............@.@..@.
....@....@........@@
...........@......@@
....@..........@..@@
@.........@.@.......
.....@..............
.@....@.............
........@........@..
.@........@..@..@...
.....@.....@........
........@....@.@....
..@.................
.......@.........@@@
..@........@..@..@@@
.................@@@
.................@@@
7
2 14 0
3 2 0
17 6 0
12 1 1
0 6 1
1 4 2
14 0 2

4 16 0
17 12 0
14 19 0
19 15 1
8 4 1
5 17 2
13 13 2
