width 20
height 20
..@............@@@@.
.......@........@...
.@...........@...@.@
...................@
............@.@.....
....................
@.@............@...@
......@.@.........@@
.....@......@.....@@
..@....@..@..@......
....................
....................
....................
....@.........@.....
.............@..@...
.......@.@.......@..
....@.@.............
.@@@........@.......
@@@@...@........@..@
@@@@...@............
7
17 9 0
2 3 0
12 13 0
13 12 1
14 17 1
11 7 2
6 3 2

15 8 0
9 4 0
0 17 0
11 11 1
19 11 1
0 11 2
0 0 2
