width 20
height 20
............@@......
....................
......@.@...@.......
..........@.........
....................
.......@..@.@.......
@..@......@....@....
@....@...........@..
.@.........@..@.....
.......@............
.@.....@..@.........
....................
...............@....
.....@...........@..
........@...........
..@.........@.......
....@@.........@..@@
........@.........@@
................@.@@
.................@@@
7
13 6 0
19 3 0
18 4 0
11 15 1
1 13 1
12 4 2
17 17 2

14 6 0
10 19 0
4 18 0
3 1 1
11 0 1
11 11 2
0 3 2
