width 20
height 20
@...................
@...................
....................
......@..@..........
.................@..
......@.............
.......@............
....@.......@...@...
.................@..
..@.........@.......
....................
.........@...@......
@.....@.....@...@...
..@.................
.@.........@@..@....
..........@@@.......
.....@.............@
..@.@.........@..@..
....................
....................
7
1 5 0
18 6 0
0 11 0
14 7 1
10 9 1
8 10 2
14 13 2

3 2 0
5 5 0
0 14 0
5 9 1
10 10 1
19 1 2
14 14 2
