width 20
height 20
..............@....@
........@.....@.....
...............@....
..@.................
...@.....@........@.
....................
.......@.@..........
....@.....@..@@@....
.......@......@@....
.......@.@.@........
..@.................
@@.............@....
.....@..............
....@.......@.......
.@....@.............
...@..........@.@...
....................
.....@....@.@.......
................@...
..............@.....
7
17 10 0
12 12 0
11 0 0
16 16 1
16 2 1
13 11 2
19 9 2

5 15 0
13 5 0
6 15 0
11 11 1
1 16 1
17 14 2
18 8 2
