width 20
height 20
............@.....@@
...................@
....................
.............@......
..........@.........
......@...@.....@...
........@.....@.....
..@.@...............
........@...........
...........@.@...@..
................@...
@...@...............
@...........@...@...
@............@......
@@@.....@.........@.
@@@........@........
@@@.................
@@..................
@@..@........@......
@..............@....
7
10 19 0
13 11 0
14 4 0
13 19 1
13 15 1
13 5 2
18 18 2

13 0 0
8 0 0
9 15 0
2 9 1
19 4 1
3 17 2
15 12 2
