width 20
height 20
.@..@@@@@@@@........
....@@@@@@@@@....@..
.@...@@@@@@@@.......
......@@@@@@....@...
.....@.@@.@....@....
....................
....................
...@.............@..
.@...........@......
....................
..@..........@......
.......@..........@.
.............@......
@................@..
...@....@...@...@...
@........@..........
....................
....................
.@...............@.@
....@............@@@
7
4 14 0
5 15 0
5 5 0
19 0 1
17 12 1
11 12 2
8 16 2

18 16 0
8 12 0
19 17 0
7 6 1
0 3 1
17 2 2
18 10 2
