width 20
height 20
....................
....................
.........@...@..@...
@....@..............
@.@.@.........@.....
....................
.@..................
.........@....@.....
......@....@...@....
.................@.@
.............@......
........@......@....
...@..@.............
.....@.@............
....................
....................
......@..@..@@......
....................
......@..@..........
....................
7
2 18 0
8 7 0
14 6 0
9 0 1
7 0 1
12 11 2
10 17 2

9 6 0
18 19 0
13 5 0
6 19 1
18 17 1
10 5 2
1 1 2
