width 20
height 20
....@...............
....................
..@.........@...@...
...@..........@.....
.......@............
....@......@..@.....
....................
.....@......@..@...@
...............@...@
........@.@.@.@.....
........@....@......
........@...........
...@.........@......
....................
.......@............
......@.........@...
.........@..........
..@.............@...
.........@@@........
@...@....@@@@@@@....
11
19 10 0
15 2 0
18 16 0
2 10 0
6 14 1
6 8 1
4 10 1
12 8 1
7 17 2
14 10 2
17 3 2

3 1 0
0 16 0
7 5 0
18 14 0
0 0 1
9 7 1
4 10 1
6 19 1
6 7 2
15 11 2
14 14 2
