width 20
height 20
@..@................
@..@..........@.....
.......@.@@.....@...
....................
.............@......
....................
....................
.@...........@....@.
..@.@..@......@.....
...@....@..@........
@..............@....
......@...........@@
.............@..@...
........@...........
...@..@.............
.........@@@@.......
...........@....@...
....@.....@......@..
....................
.@..............@@..
11
8 5 0
10 7 0
17 1 0
2 2 0
4 1 1
18 15 1
6 9 1
7 5 1
5 14 2
18 18 2
5 3 2

7 18 0
14 14 0
7 11 0
13 5 0
17 18 1
8 15 1
12 3 1
12 16 1
5 14 2
1 4 2
5 2 2
