width 20
height 20
....................
....................
.....@..@....@...@..
@.........@.........
@.............@.....
...@.@.....@........
............@..@....
...@..@.............
@......@....@..@.@..
....................
@......@............
....................
....@.@@.@....@.....
........@........@..
.@..................
..@..@..............
.......@.@....@.....
.......@@...........
......@@@.........@@
......@@@.......@@@@
11
14 19 0
19 10 0
1 7 0
3 2 0
15 5 1
13 3 1
7 9 1
2 9 1
19 4 2
17 14 2
5 18 2

14 19 0
16 8 0
3 14 0
11 11 0
6 16 1
1 19 1
2 3 1
2 16 1
6 14 2
19 3 2
4 5 2
