width 20
height 20
..@................@
....................
.......@...........@
..................@@
...................@
....@@@.............
.@..................
@@......@..@..@..@..
@...@..@............
.@.@................
..@.......@.@.@...@.
......@..@..........
..@...........@.....
.............@..@...
.......@@...........
.......@.....@......
.......@............
.........@..........
....................
..................@.
11
0 11 0
17 6 0
17 19 0
3 10 0
3 7 1
12 6 1
0 16 1
17 14 1
1 15 2
11 11 2
3 1 2

11 15 0
17 5 0
6 1 0
16 19 0
2 5 1
13 7 1
6 12 1
12 9 1
7 17 2
4 2 2
9 7 2
