width 20
height 20
....................
....@...............
..........@.........
..............@..@..
....@.@...@.........
..............@....@
....................
.............@.@....
..@................@
.........@........@.
.......@....@.@.....
...@................
..@....@..@..@.@....
......@.....@...@..@
..@.@..@.........@.@
............@.......
@......@.@.....@.@..
........@...@.......
.@...@..............
.....@.....@@.......
11
4 2 0
4 0 0
12 4 0
4 16 0
5 11 1
7 6 1
16 15 1
3 18 1
14 15 2
4 12 2
13 15 2

17 13 0
3 4 0
8 8 0
5 9 0
5 12 1
17 19 1
18 13 1
5 14 1
0 5 2
12 2 2
3 8 2
