width 20
height 20
................@@@@
........@..@.....@@@
....................
.................@..
....@..@......@.....
....................
...............@....
........@.@.@.......
...@......@.@.@..@..
....................
............@..@....
....@.@......@......
...@................
..............@.....
.....@..............
......@....@....@...
.....@..@.@......@..
...@................
....................
....................
11
19 2 0
2 19 0
6 9 0
1 18 0
18 19 1
17 19 1
6 4 1
4 3 1
12 16 2
10 6 2
4 15 2

19 5 0
8 5 0
12 3 0
11 7 0
18 19 1
6 13 1
14 9 1
19 19 1
0 1 2
1 16 2
4 19 2
