width 20
height 20
....................
........@...........
...@@@..............
.....@.....@....@...
..........@....@...@
.........@........@@
....@..@.......@@@@@
........@...@..@@@@@
....@..@..@......@@@
.@...........@...@@@
..@..............@@@
.................@@@
......@......@..@@..
................@@@.
..........@.@.@@@@..
....@......@........
.....@..............
.........@.@........
........@........@..
....................
11
16 17 0
19 15 0
6 14 0
4 5 0
3 14 1
1 1 1
5 4 1
2 4 1
12 1 2
1 18 2
3 0 2

12 0 0
0 0 0
18 1 0
11 4 0
19 12 1
9 19 1
14 12 1
12 5 1
10 15 2
0 15 2
12 13 2
