width 20
height 20
...................@
.........@.@.......@
.......@..@.........
....................
.......@...@........
.@...@.........@....
...@............@...
....................
.....@...........@..
.............@......
@...............@...
@...................
......@.............
.............@.@....
.....@..............
...@....@...........
..@....@.@......@...
.............@...@..
....@...............
@@@.................
11
3 9 0
15 14 0
16 18 0
0 2 0
13 16 1
13 7 1
0 14 1
3 7 1
17 6 2
13 0 2
19 2 2

18 19 0
11 14 0
3 12 0
1 14 0
9 5 1
2 15 1
2 12 1
2 7 1
18 9 2
6 18 2
10 19 2
