width 20
height 20
...@@...............
....@@..............
.@..@@.@........@...
@............@......
......@...@....@...@
...@...@.....@.....@
...................@
...@...@.......@....
...........@........
...................@
...@...............@
..@.....@.........@@
..............@.....
.................@..
....@.....@.....@.@.
@..............@....
..@......@.@........
....................
....................
.@...@@.........@...
11
16 1 0
9 0 0
6 5 0
19 2 0
15 8 1
16 10 1
9 12 1
5 8 1
9 2 2
15 0 2
15 13 2

17 1 0
11 3 0
6 5 0
16 9 0
4 8 1
18 10 1
1 3 1
14 16 1
19 13 2
8 6 2
1 1 2
