width 20
height 20
...................@
..............@.....
........@...........
...@......@.........
............@.......
..@.....@...........
...@................
....@...............
.@.....@.........@..
....................
........@...........
.............@...@..
....@......@........
.@.....@.....@......
..@..@.@............
.............@..@..@
@@.............@....
@@..@...............
@@.......@.......@..
@@.................@
11
11 13 0
8 9 0
4 6 0
14 8 0
11 4 1
10 0 1
18 15 1
9 5 1
11 11 2
3 12 2
18 2 2

5 1 0
1 1 0
3 19 0
2 18 0
6 3 1
13 3 1
9 12 1
11 18 1
2 7 2
17 6 2
15 5 2
