width 20
height 20
....................
.........@..........
..............@.....
....@.....@.........
....................
....@...............
....................
.........@....@.....
.@.........@........
.................@..
...@....@....@......
..............@.....
...................@
..............@.....
.....@..@...@.....@.
....................
...@...@.@.........@
..............@...@.
....................
..........@.........
11
12 18 0
11 2 0
3 9 0
10 5 0
16 10 1
0 13 1
15 15 1
19 5 1
10 0 2
6 4 2
15 6 2

2 1 0
1 18 0
14 12 0
4 2 0
0 0 1
15 10 1
10 2 1
0 17 1
0 18 2
18 12 2
6 18 2
