width 20
height 20
...@.@@....@@.......
.....@..............
..@.................
..@.......@.........
.......@....@.......
...@................
....................
..@..@....@......@..
............@.@.....
..............@.....
........@......@....
........@...@...@...
....@@@...@.........
....@@.........@....
....@@...@..@....@..
.@..@........@......
....@..@............
..@...............@@
.......@.@..........
....................
11
18 2 0
17 2 0
12 19 0
16 19 0
12 1 1
9 4 1
15 3 1
13 16 1
16 1 2
10 17 2
11 1 2

0 12 0
7 3 0
0 3 0
5 11 0
11 1 1
10 13 1
14 13 1
3 2 1
16 1 2
13 2 2
10 17 2
