width 20
height 20
...............@@@..
...............@.@..
.@..................
.....@....@.@.@.....
...............@@...
..@..@.........@....
...@................
..................@@
.....@.....@........
@...@...@......@....
@@..................
@@..................
@@..................
@@......@...........
....@...............
.......@..@....@....
....................
....@.......@@@.....
...........@@@......
...........@@@@@...@
11
2 9 0
0 3 0
13 16 0
19 15 0
13 6 1
12 10 1
9 14 1
14 18 1
14 11 2
13 9 2
1 3 2

17 3 0
6 9 0
4 16 0
18 16 0
5 17 1
0 6 1
19 0 1
3 4 1
13 11 2
4 2 2
10 1 2
