width 20
height 20
.........@......@@@@
...................@
....@...............
....@@@@.....@......
..............@.@...
....@..@............
.@...........@....@.
....@.@...@.........
..................@.
...@@@@@@........@..
..@@@@@.....@...@...
..@@@......@..@.....
..@.................
....@...............
.@............@.....
.....@..............
........@..@....@...
.@................@@
..................@@
.............@......
11
3 4 0
17 3 0
4 16 0
11 0 0
3 15 1
3 0 1
12 13 1
14 16 1
2 19 2
18 11 2
9 1 2

0 4 0
10 1 0
2 2 0
11 13 0
16 3 1
17 1 1
14 12 1
5 16 1
13 18 2
0 12 2
19 19 2
