width 20
height 20
..@.................
....................
..@......@...@......
........@.......@.@.
...........@..@.....
...............@....
..@...@...@.........
..............@.....
.@..@...............
................@...
@@.@..@...@.........
@...............@...
@........@........@.
@...@@..............
.....@......@.......
........@..@...@....
..................@.
....@.....@...@.....
....................
....................
11
15 0 0
3 11 0
3 15 0
3 3 0
5 15 1
15 8 1
13 5 1
19 7 1
19 0 2
18 0 2
11 2 2

17 1 0
11 3 0
1 2 0
6 7 0
3 16 1
0 7 1
5 3 1
1 7 1
1 11 2
17 0 2
9 4 2
