width 20
height 20
...@@@@.........@@@@
...@@@....@........@
....@@...@..@.......
.................@..
....................
..............@@....
.........@...@@@....
.............@@@....
@..........@..@.....
@..@.....@..........
..@.................
........@....@......
..@@...@............
...............@....
.........@....@.....
.....@.@..........@.
............@.......
...................@
......@............@
............@......@
11
12 13 0
16 18 0
15 17 0
8 14 0
7 8 1
16 12 1
6 16 1
10 7 1
0 12 2
13 5 2
8 4 2

7 4 0
12 9 0
1 0 0
8 14 0
12 13 1
17 13 1
17 1 1
19 16 1
16 14 2
17 15 2
19 15 2
