width 20
height 20
..................@@
..@.......@....@..@@
...@.@.............@
..........@.........
......@..@..........
..........@.........
....@@@..........@..
....@.@......@......
..@.....@...........
....@.@.............
.......@.@...@......
...@.........@...@..
....................
.......@..@......@..
..@...@.....@.......
....................
......@@.......@....
.@@@@@@@..........@.
..@@@@@@@...........
..@@@@@@@..@....@...
11
7 6 0
11 6 0
9 19 0
8 5 0
3 1 1
12 3 1
18 19 1
18 6 1
7 7 2
8 13 2
0 18 2

8 7 0
5 15 0
14 8 0
12 12 0
2 9 1
8 17 1
3 1 1
19 9 1
17 19 2
3 4 2
18 3 2
