width 20
height 20
.........@@.........
.........@..........
.....@..............
....@.........@..@..
...@...........@....
..............@...@@
...@........@.......
........@...........
...........@......@.
..........@....@....
....................
..............@...@.
......@..@.@...@....
..@.................
.@......@...........
@................@..
....................
.@.............@..@.
.........@..........
@...................
11
8 12 0
10 14 0
13 13 0
1 12 0
11 18 1
9 10 1
14 9 1
9 2 1
17 6 2
15 13 2
10 5 2

18 0 0
19 18 0
0 11 0
13 15 0
1 1 1
10 11 1
4 13 1
19 19 1
5 18 2
15 15 2
6 6 2
