width 20
height 20
..................@@
@@..................
@.....@.............
..........@.........
........@......@@.@.
@.....@...@........@
.@.................@
...@..........@.....
.....@......@.......
@..........@......@.
........@.@...@.....
..@...........@.....
@.....@..........@@@
....@...@@.......@@@
........@@.......@@@
.@...............@@@
......@...@@....@.@@
@...@.............@@
@.................@@
@@....@...........@@
11
17 1 0
14 1 0
16 15 0
14 16 0
0 15 1
2 18 1
14 12 1
12 13 1
15 1 2
0 10 2
1 14 2

17 2 0
2 19 0
4 11 0
9 4 0
16 17 1
18 2 1
3 0 1
4 0 1
15 17 2
3 1 2
16 14 2
