width 20
height 20
...@.............@@@
....@............@@@
.....@.@..........@@
...............@.@.@
...............@...@
......@..@.@..@@...@
...................@
....@...@...@......@
.........@.@....@..@
...................@
...........@.....@.@
......@......@...@@@
..@.............@...
.....@..............
..........@.....@...
..................@.
...@...@.@..........
........@.....@.....
....................
@...................
11
12 9 0
4 4 0
14 15 0
18 7 0
0 1 1
5 6 1
10 6 1
0 11 1
18 3 2
14 2 2
17 6 2

10 12 0
5 11 0
17 15 0
4 8 0
2 9 1
9 12 1
0 18 1
19 18 1
15 6 2
10 7 2
5 5 2
