width 20
height 20
....................
............@.......
...............@@...
.......@.@......@@..
........@.@.@.......
.............@......
.@......@.......@...
................@@..
..@..@...@.@........
...............@....
...........@........
.....@.....@........
.............@......
..@....@.......@....
......@............@
.................@..
..........@.......@.
....................
....................
....@.....@...@@@...
11
7 12 0
6 13 0
10 18 0
17 2 0
11 3 1
10 10 1
0 7 1
2 7 1
5 18 2
19 12 2
2 1 2

4 13 0
6 12 0
11 18 0
13 0 0
12 12 1
0 18 1
0 12 1
8 12 1
9 12 2
6 3 2
19 18 2
