width 20
height 20
.........@@@..@..@@@
........@@@@......@@
....@............@@@
.................@@@
@..........@.....@@@
@@..............@...
......@.@...........
@..@......@..@.@....
@........@..........
...............@..@@
.......@..@...@.@..@
.....@..............
................@...
.@......@...........
.............@..@...
...@....@...........
......@.............
....................
.@@@.........@...@..
.............@@.....
11
15 10 0
11 15 0
1 15 0
2 7 0
10 13 1
4 11 1
18 7 1
4 13 1
13 6 2
2 14 2
0 3 2

10 2 0
11 15 0
3 8 0
4 4 0
16 4 1
7 18 1
15 15 1
10 16 1
13 3 2
4 14 2
2 4 2
