width 20
height 20
@..@@@@@@@@@@@@@@@@@
.@..@.@.@@@.@.@@@@@@
...@...........@@@@@
.@..@@@.@@.@@.@.@@.@
.@@.@@..@.@@........
..@@..@.....@.@.@@@.
.@...@@.@.@@...@....
...@...@....@@@@.@.@
@.@..@@@@.@.@.....@@
@@.@.@.@.@..@@.@.@@@
@..........@@..@@@@@
@@@.@.@.@.@.@@@.@@@@
..@.@.@@@@@.@.@.@.@@
.@@@....@..........@
.@@.@@.@.@.@.@@.@.@.
.......@.@@.@.@..@..
@.@.@@.@..@...@.@.@.
...@.....@@.@.......
@.@..@.@....@@.@.@.@
@@@@..@..@.@@@..@@.@
9
1 10 0
4 19 0
17 6 0
16 15 1
5 13 1
8 7 1
17 17 2
3 8 2
16 18 2

18 13 0
9 2 0
15 16 0
7 13 1
2 17 1
11 8 1
9 16 2
4 2 2
7 5 2
