width 20
height 20
.@.....@...@@@.@@..@
..@.@@...@@.@..@@@.@
.@.@.@.@@.@.@@..@...
...............@.@.@
@@.@.@.@.@.@.@......
.@..@...@.@.@.@.@@.@
...@@@.@@...@..@....
.@..@..@.@.@.@.@@.@.
..@.@@@...........@@
.@...@@@.@.@.@.@.@@.
@@@.@@@...@@@..@.@..
@@...@.@.@.@@@@.@..@
@@@.@.......@.@..@.@
..@@@@.@.@.@...@....
@...@.@@@..@@.@..@@.
@@.@...@.@.@....@.@.
@....@.....@@@@....@
.@.@.@@@.@.@.@.@@.@.
....@.@@.@........@.
@.@....@.@@.@.@.@...
9
6 13 0
2 14 0
10 11 0
5 5 1
6 16 1
18 2 1
6 12 2
8 0 2
3 19 2

1 13 0
0 3 0
10 16 0
18 0 1
14 6 1
17 13 1
10 14 2
2 15 2
19 13 2
