width 20
height 20
@@@...@.@@@.@@@@@@@@
@@.@.@...@...@@@@@@@
@.....@.@.@.@@@@@@@@
.@@@@........@.@@@@@
..@.@@.@.@.@....@@@@
@.......@@@..@.@@@@@
@.@@.@.@@@@@..@@@@@@
@.@.@.@.@@...@@@@@@@
....@.@...@@.@@...@@
@.@.@...@@@...@.@.@@
...@@.@...@@.@..@...
@.@@..@@@@@....@@@@@
@...@.@.@@@@@@..@.@.
@.@......@@@.@@.....
..@.@.@.@.@..@@@.@@.
@.@@@@..@...@.@.@.@@
@@@@@@@...@.........
@@@@@@@@.@..@.@@.@.@
@@@@@@@@@@@..@@@@...
@@@@@@@@@@@@@@@@@@.@
9
5 5 0
11 1 0
15 15 0
3 12 1
7 15 1
1 12 1
2 5 2
8 17 2
2 12 2

16 13 0
1 4 0
10 3 0
15 9 1
11 11 1
15 8 1
13 17 2
19 14 2
5 7 2
