width 20
height 20
@@@@@..@@...........
@@@@..@...@.@.@@@@.@
@@..@.@.@.@@..@.....
...@.....@..@@@.@.@.
@@.@@.@.@@.@.@.@.@..
@..@...@@@........@.
.@..@.@@@..@@@.@@...
..@.@.@@.@...@@...@@
@....@.....@@@@.@.@.
@.@.@@@.@.@..@...@..
..@..@.@@.@.@.@@..@.
@..@@....@.......@@.
..@...@@@..@.@.@....
.@.@@.@.@@..@@@@@.@@
........@@.@.@.@....
@.@.@.@.........@@@.
...@@.@@.@.@.@.@.@..
@.@@@@....@@@..@.@@@
@..@...@.@@@@.@@.@@@
@@@@.@..@@@@......@@
9
2 3 0
13 1 0
1 10 0
14 16 1
14 5 1
5 0 1
7 15 2
8 16 2
8 7 2

1 18 0
18 6 0
17 19 0
5 7 1
17 5 1
11 11 1
12 19 2
8 3 2
10 15 2
