width 20
height 20
@@...@@.@..@.@@@@...
@.@.@@@...@@..@@.@@.
.....@..@..@@.@.....
@.@.@.@..@......@.@.
@..@....@@.@.@.@@.@@
@@.@@.@..@@@@@@@....
@....@..@..@.@@.@@.@
.@@.@.@..@..........
.......@@.@.@.@.@.@@
.@.@.@.@....@@.@..@@
@..@.@...@.@@@..@@..
.@..@@@.@@@@@..@@.@.
.@@...@@@@.@.@......
..@.@...@......@.@@@
.@@.@.@...@.@.@.....
..@@.@@.@..@@@..@@@@
.@.....@..@.@.@.....
..@.@.@@@@......@@.@
.@.@.......@.@.@....
.....@.@@@..@..@@.@.
9
4 8 0
10 19 0
6 4 0
2 11 1
12 18 1
9 18 1
0 14 2
15 2 2
11 17 2

0 18 0
10 17 0
10 15 0
16 1 1
17 2 1
12 1 1
3 13 2
6 19 2
11 3 2
