width 20
height 20
@@@.@.@.@.@.@@....@.
@@....@.@......@.@@.
@@@.@.....@@.@@.....
@@.@@.@@.@.@@..@.@.@
@.....@.@.....@.@@.@
..@.@...@@@.@......@
@..@@.@...@@.@.@.@..
..@@@@..@....@@@@@.@
.@@@@@@@..@.@@@@....
.@@@@@@..@.@@@@@.@.@
@@@@@@@@@...@@@...@@
@@@@@@@@@@.@.@.@@.@.
@@@@@@@@@@..........
@@@@@@@@@@.@@@.@@.@.
@@@@@@@@@@@......@@@
@@@@@@@@@@.@.@.@..@@
@@@@@.@.@.....@..@@@
@@.@......@.@.@@..@@
.....@.@@..@@@...@.@
@.@@@@@@@.@@@..@...@
9
13 5 0
14 13 0
16 12 0
10 16 1
10 3 1
17 19 1
1 18 2
16 9 2
5 2 2

7 1 0
7 5 0
17 17 0
1 6 1
13 4 1
5 0 1
4 18 2
15 5 2
16 19 2
