width 20
height 20
@@...@.@.@@@@@@@@@@@
@.@@.....@@@@@@@@@@@
@.@@@.@@.@@@@@@@@@@@
...@..@....@@@@@@@@@
@.@.@@.@.@@.@@@@@@@@
.............@@@@@@@
@.@.@.@.@.@.@@@@@@@@
..@@@@.@@@..@@@@@@@@
@@......@@@..@@@@@@@
..@@.@@@....@@@@@@@@
.@.@.@...@@.@@@@@@@@
.......@.@.@.@@@@@@@
@@.@.@.@@@.@.@@@@@@@
...@@..@@....@@@@@@@
.@.@@@.@..@@@@@@@@@@
.@@.....@...@@@@@@@@
...@.@@...@@@@@@@@@@
.@@.@...@@.@.@@.@@@@
..@..@@..........@@@
@...@@@@.@.@.@.@.@@@
9
8 5 0
3 19 0
4 15 0
11 10 1
7 15 1
2 5 1
0 13 2
1 18 2
4 12 2

12 5 0
2 16 0
16 19 0
15 17 1
0 3 1
1 7 1
5 8 2
1 13 2
10 12 2
