width 20
height 20
@.@.....@@.@@@.@@...
...@@@.@.@.......@.@
@.@.@.....@.@@.@....
......@.@....@@..@@.
.@.@@@@@.@@.@..@..@.
.@...@@@......@@.@@@
..@.@@@..@.@.@@@@@@@
.@..@@.@..@@.@@@@@@@
@.@..@...@@.@.@@@@@@
....@@.@@......@@@@@
@.@..@.@.@@.@.@.@@@.
...@@.....@@@....@..
@.@..@@@.@.@..@.@.@.
..@@..@@.....@......
.@@.@.@.@@.@..@.@.@@
..........@..@@@@@@@
@.@.@@.@.@..@@.@@@@@
@@@@...@@@@.....@@@@
@.@.@@..@...@@.@@@@@
.......@..@...@@@@@@
9
4 19 0
10 5 0
4 3 0
17 0 1
8 10 1
12 5 1
12 6 2
5 0 2
16 2 2

10 14 0
8 19 0
7 8 0
10 0 1
12 17 1
12 3 1
12 7 2
0 13 2
3 9 2
