width 20
height 20
@@@@@@@@@......@@@@.
@@@@@.@.@.@@.@.@.@..
@@@@......@.@.@....@
@@@@.@.@@.......@.@@
@@@@@@@@@@.@@.@..@@@
.@@@.@@@@@@@@@..@@@@
.....@@@@@.@@..@.@@@
.@.@.@@@@@...@....@@
@@@...@@@..@.@.@.@.@
.@.@.@.@.@.@....@...
.........@.@.@.@.@.@
.@.@.@.@....@.@@....
.@@@@.@.@.@......@.@
....@.@.@@.@.@.@.@@@
@.@.........@@@..@.@
@@..@.@.@.@@@@@@....
@@@@..@..@@@@@@@@.@.
@@@@@..@@@@@@@@@@@..
@@@@.@...@@@@@@@@@@.
@@@....@@@@@@@@@@@@@
9
18 14 0
19 18 0
18 17 0
13 4 1
13 12 1
1 14 1
0 12 2
19 11 2
6 14 2

19 17 0
10 8 0
12 0 0
16 1 1
17 15 1
15 12 1
8 2 2
8 18 2
15 7 2
