width 20
height 20
..@@@@@..@...@....@.
.@.@@@.@..@@..@.@@..
.....@...@.@.@.....@
@.@.@.@@.......@.@..
@@.......@.@.@.@@@.@
@@@.@.@.@.@.@@@@@...
@@...@@@....@@..@.@.
@.@.@@@@.@.@...@.@@@
.........@@@.@@..@.@
@.@@@.@@@.@.....@...
@@.@.......@@@@.@@.@
@..@@.@@.@..........
@@...@..@@.@.@.@.@.@
@.@.@.@.@.@.@.@.@...
@.................@.
@@.@.@.@.@.@@.@.@.@@
....@@@.@....@.@@@.@
@@.@@...@@.@........
@.....@..@@..@@.@.@.
@@.@.@..@@@@.@...@..
9
0 16 0
5 9 0
10 2 0
8 2 1
11 5 1
14 12 1
0 2 2
2 16 2
4 6 2

3 6 0
9 10 0
1 3 0
2 17 1
6 19 1
17 9 1
16 11 2
8 6 2
6 4 2
