width 20
height 20
.@..@.@@@.@....@..@@
.@.@..@@...@.@..@..@
.....@.@@.@@@.@.@.@@
.@.@....@.@........@
.@@.@@.@...@.@.@.@..
@.@....@.@@@..@@@..@
....@.@..@@@@@.@.@.@
.@.@.@@.@@@@.@......
..@......@@@...@@.@@
.@@@.@.@..@..@.@@@@.
...@@@@..@.@..@.@.@.
.@.....@....@.@.....
..@.@@.@.@@@....@.@.
@.@@...@....@@.@@@..
@..@@@..@.@.@.@.@.@.
.@..@..@@@..........
...@.@@.@.@.@.@@.@.@
.@...........@@.@..@
..@.@.@@@.@@.@....@@
.@@..@.....@.@@.@...
9
18 11 0
13 8 0
15 1 0
16 15 1
15 2 1
12 12 1
12 10 2
13 5 2
8 10 2

0 12 0
5 13 0
18 7 0
2 2 1
0 15 1
6 3 1
2 10 2
17 17 2
1 12 2
