width 20
height 20
@@@@@.@@@..@.@.@.@@.
@@@@@.@@..@..@...@@.
@@.@..@..@.@...@....
@@.@.@.@...@.@@..@.@
@........@....@.@...
@@.@.@.@..@@@.@@..@.
@...@@@..@@....@@@..
.@.@.@@@..@@@.@@@@@.
......@..@@@@@@@....
.@.@@.@@@@@@@@@..@.@
.@.@.@.@.@.@.@.@@..@
.@.............@..@@
@..@.@.@@.@.@@..@@@@
.@..@@@.@@@@.@.@.@.@
...@.@@.@.@@...@....
.@.........@.@...@.@
..@.@.@@.@..@..@@@..
.@.@@@.@..@.@@....@@
.@.......@..@@@.@@@@
..@@.@.@.@@@@@@..@@@
9
13 7 0
14 12 0
8 19 0
18 14 1
12 13 1
10 4 1
10 3 2
0 18 2
14 2 2

2 8 0
16 1 0
16 8 0
4 10 1
8 10 1
10 10 1
11 4 2
3 13 2
19 7 2
