width 20
height 20
@@@@@@@@.@@...@.@.@.
@@@@@@@@..@.@.......
@@@@@@@@.@.@..@@.@@@
@@@@@@......@.@.@@@@
@@@@@@.@.@.@.....@@@
@@@@@@.@@...@.@.@.@.
@@@..@...@.@.@......
@@@@.@@.@....@.@@.@@
@@.@.@.@.@.@@.@.@...
..................@.
.@.@.@.@@.@.@.@.@@.@
.@@..@...@@@..@..@..
@..@..@.@@@@@.@.@.@.
@.@..@.....@@@@.....
@.@.@@@.@.@@@@@@.@.@
....@@@@@@@@@@@@@...
@@.@@@@@@@@@@@@@@@.@
@@..@@@@@@@@@@@@@@@@
@..@@@@@@@@@@@@@@@@@
@.@@@@@@@@@@@@@@@@@@
9
9 14 0
8 3 0
7 12 0
19 0 1
10 3 1
3 6 1
13 5 2
7 7 2
10 8 2

13 2 0
13 10 0
12 2 0
15 4 1
15 10 1
2 9 1
2 12 2
7 14 2
7 7 2
