width 20
height 20
@@@@@@@@@@@@@@@@@@@@
@@@@@@@@@@@@@@@@@@@@
@@@@@@@@@@@@@@@@@@@@
@@@@@@@@@@@@@@@@@@@@
@@@@@@@@@@@@@@@@@@@@
@@@@@@@@@@@@@@@@@@@@
@@@@@@@@@@@@@@@@@@@@
@@@@@@@@@@@@@@@@@@@@
@@@@@@@@@@@@@@@@@@@@
@@@@@@@@@@@@@@@@@@@@
@@@@@@@@@@@@@.@.@@@@
@@@@@@@@@@@@.....@..
@@@@@@@@@@@.@.@.@.@.
@@@@@@@@@@@.@..@....
@@@@@.@.@@..@.@.@.@@
@@@@.......@........
@@@@@.@@.@.@@.@.@@.@
@@@@..@.@......@...@
@@@@@....@.@.@.@.@..
@@@@@@.@.@@...@...@.
9
8 16 0
17 17 0
16 19 0
18 18 1
18 15 1
16 11 1
17 13 2
9 15 2
13 16 2

15 10 0
5 15 0
15 12 0
12 17 1
13 15 1
9 15 1
16 13 2
13 17 2
4 17 2
