width 20
height 20
@..@...@@@@@@..@.@..
..@.@.@.@.@@..@@..@.
@..........@@.@.@...
.@@.@@.@.@.@......@.
....@...@...@.@.@@..
@.@..@.@.@.@@@@..@@.
@@@.@.@@......@.@@@.
@.@@...@.@@.@..@@@..
...@.@....@@@.@.@@@.
@.@...@.@..@@....@..
....@@.@.@@@@.@@.@@.
@@.@.......@@.@..@..
.....@.@@@.@.@.@@.@.
@.@@.@..@...........
@@.@@.@@.@.@.@.@.@.@
@...........@.@.@.@@
.@.@@.@@.@.@@......@
.@.@....@@.@.@@.@@@@
....@.@..@.........@
.@.@@@..@@.@.@.@.@..
9
2 4 0
4 0 0
10 4 0
19 6 1
8 3 1
10 9 1
6 15 2
5 1 2
8 10 2

10 11 0
16 18 0
19 4 0
9 1 1
8 2 1
7 17 1
13 1 2
16 11 2
2 2 2
