width 20
height 20
.....@@..@.@@.....@.
@.@.@.@.@..@..@.@...
@@........@.@..@@@.@
@@@.@.@.@.....@.@@@@
@@@..@@@@.@.@...@@@@
@@..@....@..@@.@.@.@
@.@.@@@.@@@@@.@@....
....@@@..@.@@.@.@.@.
.@@.@...@@........@@
.@.@.@@....@@.@.@@..
.....@.@.@.@..@.@..@
.@.@....@@..@@..@@.@
..@..@.@.@.@..@..@..
@@@@.@.......@..@.@.
@@@@@@@@@.@.@@@.....
@@@@@@@@@@@@@@@@@.@.
@@@@@@@@@@@@@@@....@
@@@@@@@@@@@@@@@@.@..
@@@@@@@@@@@@@@@@@..@
@@@@@@@@@@@@@@@@@@..
9
11 11 0
14 0 0
18 5 0
0 11 1
1 6 1
5 11 1
5 5 2
19 17 2
12 12 2

10 5 0
0 9 0
3 1 0
15 16 1
5 1 1
7 8 1
14 0 2
10 10 2
1 12 2
