width 20
height 20
..@..@@.@@....@..@@@
.@.@.@..@.@.@...@@@@
......@......@.@@@@@
@.@@.@..@.@.@@.@@@@@
@@.....@@@@@@.@.@@@@
@@@@.@....@.@....@@@
@@@@@..@@@....@.@.@@
@@@@@@.@.@@.@@.....@
@@@@@.........@@@.@.
@@@@@@.@.@@.@..@....
@@@@@...@..@@.@.@.@.
@@@@.@@...@@....@@..
@@@.....@.@@@.@.@.@.
@@@@@.@.@@.@@@.@....
@@@@...@....@...@@.@
@@@@.@...@.@@.@...@@
@@@@@@@.@..@.@.@.@.@
@@@@@@@@@@.......@..
@@@@@@@....@.@.@...@
@@@@@@@@.@..@...@.@@
9
9 11 0
10 13 0
1 0 0
14 2 1
5 10 1
10 0 1
8 11 2
19 10 2
6 10 2

16 13 0
15 7 0
10 8 0
13 8 1
11 5 1
11 2 1
8 11 2
13 5 2
7 10 2
