width 20
height 20
.@..@.@.@.@@@@......
..@........@..@.@.@.
.@@@.@@.@.@..@@@.@..
..@..@.@..@@.@@..@@.
.@@@....@..@....@@..
..@@.@.@..@..@.@..@.
.@..@@@@.@@.@.@.@...
...@.@..........@.@@
.@.....@.@@@@.@.....
..@.@.@..@@@@@@.@.@@
@@..@@@@.@@@...@....
@.@..@@@..@.@.@@@.@.
....@@@@.@.....@@@..
.@.@.@@.@.@.@.@@@@@.
..@..........@@@@@..
.@..@.@.@.@.@..@@@@.
@@@@@@@@...@..@@....
@@@.@.@.@.@.@.@.@.@.
@@.................@
@@@.@@@.@.@@.@@.@.@@
9
19 8 0
3 15 0
19 11 0
12 12 1
13 15 1
6 5 1
8 10 2
16 18 2
3 9 2

4 13 0
9 13 0
8 8 0
12 10 1
17 8 1
18 16 1
18 10 2
1 7 2
15 18 2
