width 20
height 20
@@@@@@@@..@@@.@@@..@
@@@@@@@@@.....@.@@.@
@@@..@@@@@.@@.......
@@@@..@@@....@@.@.@.
@@@@@..@.@@.@..@@.@@
@@@@@.@@....@@.....@
@@@@..@@.@.@..@.@@.@
..@.@.@@..@@.@.@....
.@.....@.@.....@.@.@
...@.@...@.@@@.@@@@@
.@..@@@.@.@.@...@@@@
@..@@@@@......@@.@@@
..@.@...@.@@@.....@@
@...@.@@@@@..@.@.@@@
@.@...@.@.@.@.@...@@
...@.@@........@.@.@
.@@..@.@@.@@@@......
.@@@.........@@@.@.@
..@@@@.@@@.@.@@@..@@
@..@...@@@@..@...@@@
9
19 16 0
15 12 0
0 15 0
5 13 1
5 5 1
12 17 1
13 6 2
1 12 2
16 7 2

4 15 0
9 7 0
2 9 0
12 7 1
5 19 1
15 19 1
14 9 2
5 3 2
6 16 2
