width 20
height 20
@.@@@@........@@@.@@
...@@.@.@@.@.@.....@
@.@.@....@@...@.@.@.
....@.@@@..@.@@@....
@@@....@.@...@@.@.@.
@@.@.@....@@.@...@..
.....@@@@..@@@@.@.@.
@.@.@.@.@.@..@......
...@........@..@.@@.
.@.@@.@.@@@.@@.@@...
.@...@@@.@@.@@@.@@.@
.@@@@@.@............
..@......@.@.@@.@.@.
.@@@.@.@@@@..@@@..@@
...@@..@@@@@.@@@.@@@
.@..@@.@@@@@@@@@@@@@
@@.@@@@@@@@@@@@@@@@@
...@@@@@@@@@@@@@@@@@
@.@@@@@@@@@@@@@@@@@@
@@@@@@@@@@@@@@@@@@@@
9
10 4 0
3 12 0
4 5 0
16 1 1
19 9 1
15 11 1
19 12 2
15 6 2
9 3 2

10 11 0
19 4 0
6 13 0
18 9 1
19 8 1
14 9 1
3 15 2
11 10 2
0 3 2
