width 20
height 20
@.@...............@@
....@.@.@.@.@.@.@...
@.@..@@@.@@@.@@@@.@@
@@@@..@.......@.@.@.
@....@@@.@@.@.......
@@.@.@@.@....@@.@.@.
@.@.....@@@.@...@..@
...@@@@.@..@@.@@.@..
@.@.@.@...@@.@@..@.@
........@.......@.@.
.@.@.@.@.@@.@.@.....
@...@....@.@.@..@.@.
.@.@.@.@...@..@..@@.
.@....@@@@...@..@@@.
...@.@@@@@.@..@..@..
@@@...@...@.@@.@@.@.
@@@@.@..@...........
@@@.@.@..@.@.@.@.@.@
@@......@.@...@@@..@
...@.@@....@.@@@@@..
9
7 19 0
0 13 0
4 19 0
11 16 1
11 15 1
1 8 1
8 4 2
11 4 2
1 14 2

19 9 0
6 11 0
6 18 0
17 4 1
10 0 1
17 15 1
12 17 2
18 8 2
16 17 2
