width 20
height 20
@@@@@@@@....@@@.@.@@
@@@@@@@@@@.@@@....@@
@.@@@@.@....@.@.@@.@
...@@..@@.@@@.......
@.@.@@.@......@.@.@.
.........@.@@..@@@..
@@.@.@.@.@@@@.@@@.@@
....@@@@@.@@@@.@...@
@@.@@@@@@..@...@@.@.
....@@@@..@..@......
.@.@..@@@..@@..@.@.@
.@@.@..@@.@.@.@.@.@@
......@@@...........
.@.@.@@@.@@@.@.@@.@.
@.@........@@.@..@..
...@.@.@@.@.....@.@.
.@.@@@@.....@.@.....
@@...@@.@.@.@@@.@.@.
@@@@....@.@...@@.@@.
@@@@@.@..@..@.@.....
9
15 4 0
6 18 0
11 12 0
9 3 1
16 3 1
13 5 1
4 13 2
18 9 2
19 9 2

0 9 0
14 8 0
13 11 0
10 0 1
4 13 1
13 6 1
8 13 2
6 15 2
17 16 2
