width 20
height 20
@.@.@@@@@@.@@@@@@@@@
@....@@@@...@@@@@@@@
.@@.@@.@.@.@.@@.@@@@
.@...@...........@@@
.@@.@.@@@.@.@.@@..@.
......@....@..@..@@.
.@.@@@@.@.@.@..@....
..@@@....@....@@@.@.
.@.@.@.@..@@@..@@@..
.......@.@....@@@..@
.@.@.@@.@@@.@.@@.@.@
..@@@.@.@@@@@.@.....
.@.@.....@@.@@.@.@.@
@...@.@@.........@.@
..@@...@.@@@@.@.@@@@
.@@.@.@......@@.@@@@
.@@.@.@@.@@.@...@@@@
.......@..@@.@.@@@@@
@@.@.@..@.....@@@@@@
@@.@@..@..@@.@@@@@@@
6
14 16 0
3 9 0
0 17 1
3 15 1
3 16 2
5 4 2

16 5 0
1 11 0
15 3 1
5 7 1
1 17 2
9 1 2
