width 20
height 20
@@@@..@@.@..@@@@@...
@.@@.@.@...@@.@...@.
........@@..@..@.@.@
@.@.@@@....@.@.@....
..@@.@.@@@.......@.@
.@.......@.@.@.@@..@
..@.@@@.@...@.@.@.@.
.@@@.@...@.@@.......
@@@@.@@.@.@.@.@.@.@.
.@....@.......@@..@.
..@@.@..@.@.@.@@.@..
@.....@@...@..@@.@@.
@.@@.@@@@.@.@...@...
..@...@@@...@.@@..@.
@..@.@.@..@@.@.@@..@
@.@.....@.@.......@@
@@.@@@.@@@@.@.@@@..@
@.......@.@..@....@.
..@@.@.@....@.@.@...
@.@@@....@.@@....@.@
6
15 15 0
19 0 0
8 9 1
5 0 1
17 14 2
10 9 2

14 4 0
15 15 0
8 5 1
0 13 1
9 11 2
14 14 2
