width 20
height 20
@@@@.@.@@@@.@.@@@@@@
@@@.....@@.....@@@@@
.@@@.@.@.@.@.@..@@.@
..@@@.......@.@.....
@..@@@@@.@.@@...@@.@
@.@.@.@.@@@...@@.@@.
.........@@@@.....@.
.@.@@.@.@.@..@.@@...
..@@@.@...@@..@...@.
@@@@@@..@....@@.@..@
@@@@@@@..@.@....@@@.
@@@@@@..@.@.@.@.....
@@@@@.@......@..@.@@
@@@@....@.@.@..@....
@@@@@.@..@...@..@.@.
@@@@@@..@.@.@..@@@..
@@@@...@.....@@.@.@.
@@@@.@..@.@.@.......
@@@@@..@@.@@..@@@.@.
@@@@@@.@@@@@@.@....@
6
13 13 0
17 11 0
12 18 1
15 4 1
7 9 2
13 8 2

13 13 0
17 19 0
19 13 1
12 7 1
10 14 2
8 2 2
