width 20
height 20
.@@@@.@@.@@@@..@@...
..@...........@@.@.@
.@@@@.@.@.@.@.@.....
..@.@..@@@@@.@.@.@@@
.@....@.@.@.......@@
...@.@@...@@.@.@.@@@
@@.@.@@.@.....@.@@@@
@...@.@..@@.@@..@@@.
.@.@..@.@.@@.@.@.@..
.@..@.............@.
...@@.@.@.@.@.@.@...
.@.@.@.@@@@.@@.@@@@.
@.......@.@....@@@@.
@@@@@.@@@...@@@.@@@@
@..@......@.@@...@@@
.@...@@.@..@@.@.@@@@
...@..@@.@......@@@@
.@..@....@.@@.@.@@@@
..@..@.@..@@@@...@@@
.@@@@@.@@@@@@@@.@@@@
6
0 17 0
9 8 0
1 16 1
8 9 1
9 1 2
14 8 2

1 16 0
6 17 0
0 15 1
8 1 1
11 6 2
10 15 2
