width 20
height 20
.@..@@@.@.@@@@@@...@
...@.@.....@.@@..@..
.@....@@@.@....@.@@.
@.@@.@.@...@.@@@@...
..@......@...@@@@@.@
@...@.@@.@@.@..@....
@.@.@@..@.@.@.@.@@.@
@..@...@............
..@@.@@.@.@.@@.@.@.@
.@........@..@@@@...
@@.@@.@.@@..@@.@.@@.
.....@....@.@.......
.@.@..@.@.@.@.@.@.@.
@@.@.@.@@.@@@.@@...@
.@@....@.@.@...@@.@@
.@.@.@.....@.@@.....
.....@.@.@..@...@.@.
@@.@.@.@@.@@.@@..@..
@@@@..@.@.......@@@.
@@@..@....@.@.@.@@@.
6
11 19 0
9 6 0
7 9 1
10 10 1
16 2 2
1 4 2

18 7 0
10 3 0
4 16 1
4 12 1
15 15 2
12 3 2
