width 20
height 20
@@@@@@@@@@@@.@@...@.
@@@@@@@@@@@.....@...
@@@@@@@@@@@@.@.@.@.@
@@@@@@@@.@@...@...@@
@.@.@......@@...@@.@
......@@.@@.@@@.....
@.@@@.@@.@....@.@.@.
...@.@.@.@.@.@.@.@..
@.@@...@@...@.....@.
.....@.@.@.@.@.@.@..
@.@.@...........@@@.
..@@.@.@.@@.@@.@....
@..@....@@@@@@@.@.@.
.@.@.@.@@@@@@@.....@
..@...@@@@@@@@.@.@@.
.@.@.@.@@@.@@...@...
........@...@@.@.@.@
.@.@@@.@.@@.@@......
..@............@.@.@
.@@@.@.@@@.@.@..@..@
6
1 10 0
0 16 0
16 8 1
2 7 1
0 11 2
5 4 2

12 6 0
17 0 0
6 19 1
14 7 1
18 5 2
12 2 2
