width 20
height 20
...@@@.@@...........
@@........@.@.@@.@.@
...@.@.@@@@@.@.@@..@
@.@.@..@@@@.......@.
.....@@.@@@.@.@@@...
@.@@.@...@.@.@..@.@@
.@@....@......@.@@@.
...@@.@..@.@.@@.@.@.
.@..@.@@.@@.......@.
@..@.@.@..@@.@.@.@..
.@.......@.@@@.@@..@
...@.@.@....@.@.@.@.
.@..@@@@@.@.........
..@.@@@@...@.@.@.@@.
.@@@.@.@@.@@@@@.@.@.
..@......@.@.@......
.@.@.@.@.......@.@.@
....@.@@.@.@.@@@@...
.@.@@.@.@...@.@@@@.@
@.......@.@.......@@
6
8 9 0
0 12 0
11 19 1
13 18 1
9 16 2
2 9 2

14 12 0
1 11 0
19 9 1
6 1 1
11 0 2
3 4 2
