width 20
height 20
@@@@@@@@@@@@@@@@@@@@
@@@@@@@@@@@@@@@@@@@@
@@@@@@@@@@@@@@@@@@@@
@@@@@@@@@@@@@@@@@@@@
@@@@@@@@@@@@@@@@@@@@
@@@@@@@@@@@@@@@@@@@@
@@@@@@@@@@@@@@@@@@@@
@@@@@@@@@@@@@@@@@@@@
@@@@@.@@@@@@@@@@@@@@
@@@@...@@@@@.@@@@@@@
@.@@.@@@@@@...@@@@@@
...@.@.@@@.@.@.@@@.@
.@@@....@...........
..@@@.@...@.@.@@@.@.
.@.@.@.@@..@..@....@
..........@@@@@@@.@.
.@@@.@.@.@@@@.@.....
@.....@...@@....@.@.
@@.@.@.@.@@@@.@..@@@
....@......@...@@@@@
6
14 11 0
0 15 0
12 11 1
13 16 1
2 19 2
15 17 2

14 19 0
15 18 0
1 10 1
19 13 1
2 15 2
1 17 2
