width 20
height 20
....@@@@@.@...@@@@..
.@@@.@@....@.@@@@@.@
..@..@.@.@@...@.@...
.@.@........@....@.@
.....@.@.@.@..@@@@..
.@.@..@...@.@..@@..@
.@..@..@.@..@.@.@@..
..@@@.@.@@@...@....@
@.@@@@@..@..@@.@@@..
@@.@.@.@.@.@@......@
.@.........@.@.@.@..
.@.@.@@.@@@@...@@.@.
....@..@.@.@.@.@..@.
@@.@.@........@@.@.@
.......@.@.@.@......
@@.@.@..@@@@@@@@.@.@
@...@@.@@@@@.@@@@...
@@.@@..@@@@@...@.@.@
@@@@..@.@@@.@.@.....
@@@@@...........@.@@
6
12 13 0
7 7 0
1 14 1
9 1 1
12 7 2
18 16 2

8 3 0
11 19 0
2 15 1
13 11 1
16 12 2
13 17 2
