width 20
height 20
@@@@@@.@......@..@@@
@@@@@....@.@.@.@..@@
@@@@@@@.@@@.....@..@
@@@@@@.@....@.@@..@.
@.@@@@..@.@.@.@.@...
@.@.@@.@@..@.@...@@.
........@.@....@.@@.
@@@.@.@.....@.@.@...
..@.@.@.@@.@@...@.@@
@....@.@@.@@.@@.....
@.@.@...........@.@.
...@.@.@.@.@.@@@@@@@
.@...@@.@@..@@@@@@@@
..@@.@@.@.@.@@@@@@@@
.@@........@@@@@@@@@
@@@@@.@.@.@@@@@@@@@@
@@@@...@@.@@@@@@@@@@
@@@@@.@@..@@@@@@@@@@
@@@@@.@.@..@@@@@@@@@
@@@@@@....@@@@@@@@@@
6
14 10 0
7 13 0
10 0 1
8 14 1
5 16 2
13 3 2

15 10 0
4 9 0
7 19 1
4 11 1
9 9 2
16 1 2
