width 20
height 20
@@@@@@....@...@@@..@
@.@.@.@.@@..@..@.@.@
..........@..@......
.@.@@.@@@@@.@.@@.@@.
@.@...........@.@@..
....@.@.@.@.@...@.@.
@.@@@.@.@@..@@@....@
@.@@.@.@@.@@....@.@@
.@.@........@.@..@@.
.....@.@.@.@@.@.@.@.
.@@.@@@@@@..@@......
..@@.@.@.@.@@@@.@.@@
.@@.........@@@@...@
.@.@.@.@.@.@.@@.@.@@
@.....@@@..........@
.@.@.@@@@@@.@@.@.@@@
...@@@@@@@@@....@@@@
.@....@@@@@@@@.@.@@@
..@.@@@@@@@@@@....@@
@@..@@@@@@@@@@@.@@@@
6
13 16 0
17 7 0
7 5 1
12 4 1
13 3 2
14 7 2

3 1 0
18 4 0
18 1 1
5 2 1
10 13 2
9 7 2
