width 20
height 20
@@@@@@@@@@@@@@@...@@
@@@@@@@@@@@@@@..@@.@
@@@@@@@@@@@@@..@.@..
@@@@@@@@@@@@.@...@.@
@@@@@@...@@@..@@....
@@@@@..@@.@@.@.@.@@.
@@@@.@..@..........@
@@@....@..@.@.@@.@..
.@.@.@@@@..@.@.@@.@.
.@........@@........
...@@@@@.@...@.@.@.@
.@.....@@@@.@.@.@...
..@.@.@.@@@......@.@
.@@@.....@..@@@@@.@.
@@@@@.@@..@...@@....
@@@@@@...@@@.@..@.@.
@@@@@..@.@@@..@..@..
@@@@@@..@@@.@...@.@.
@@@@@..@@@...@@.....
@@@@@@.....@@@@@.@@.
6
12 9 0
7 6 0
17 11 1
16 5 1
9 19 2
13 16 2

11 17 0
13 16 0
17 11 1
11 10 1
12 15 2
14 9 2
