width 20
height 20
@.....@@@..@@.....@@
@@.@.@.@.@.@..@.@..@
@.@.........@..@..@.
...@.@.@.@@@@@.@@...
@.@..@@...@.@.@.@@@.
....@..@@...........
@.@...@@@.@@@.@@@.@@
@@@@.@.@.@.@.@.@.@.@
@@@@.@.............@
@@@@..@@.@@.@.@.@.@.
@.@.@.@.@..@@@.@....
......@...@@@@..@.@.
.@.@@.@@@..@@.@...@@
@.@.@..@.@..@...@.@@
......@....@..@..@.@
@.@.@@.@.@..@.@@.@..
@@.......@@.@.@.@..@
@@@.@@@@@..@@....@..
@@..@.@@.@....@.@.@.
@@@........@.@......
6
17 5 0
10 5 0
5 16 1
2 5 1
11 15 2
7 14 2

13 15 0
6 13 0
8 2 1
10 18 1
14 8 2
15 17 2
