width 20
height 20
....@@@..@@.@@@.@..@
@.@..@@@..@..@..@.@@
@.@@..@..@@.@.@.....
.@.@.@.@..@.....@@.@
.........@..@.@@...@
.@@.@.@.@..@...@@.@.
...@@@@@@@@.@.@..@@.
.@@.@.@.@@@...@@..@.
.........@.@@..@@...
.@.@@.@@......@@@.@@
@....@@@@.@@@.@@..@@
..@@.@@@.@@..@..@.@@
@.@.@@...@..@..@...@
..@.@.@.@..@..@.@.@@
@.......@.@.@......@
@.@.@.@.......@.@@..
.@.@.@..@.@.@@.@@.@.
......@..@@..@......
.@@.@...@...@@@.@.@.
..@.@.@.@@.@@@@@...@
6
11 9 0
4 17 0
17 7 1
9 13 1
16 10 2
16 12 2

10 9 0
3 18 0
15 14 1
15 3 1
0 7 2
13 14 2
