width 20
height 20
@.@.@@.@@@@@.....@@.
........@@@@.@.@@@@.
.@.@.@.@@@@.@..@@@..
.@@.@....@....@.@.@.
..@...@.@@@.@.....@.
.@..@@.@.@@.@.@.@...
.@.@.@....@@.@.@.@.@
.@@....@@..........@
.@.@@.@..@.@.@.@.@..
......@.@.@@@.@@@@@@
.@.@.@@...@@...@.@.@
.@..@@@.@...@@......
@@.@.@.@.@.@.@.@.@@.
...........@....@@@@
.@@.@@.@.@...@.@@@@@
.@..@..@@..@@...@@@@
..@..@...@..@@.@.@@@
.@@.@..@.@.@.@@..@.@
..@@.@..@......@....
.@.....@@@.@.@...@.@
6
19 1 0
2 15 0
12 14 1
8 6 1
4 18 2
7 3 2

17 5 0
0 13 0
18 5 1
19 12 1
12 1 2
4 2 2
