width 20
height 20
@@@@@@@@@@@@..@.@...
@@@@@@@@@@@@@...@@@.
@@.@.@@.@@.@..@@@...
@..........@@..@.@.@
@@.@.@.@.@.@..@.....
@@..@.@.@.@.@.@.@.@@
@@@..............@@@
@@.@.@@@.@.@.@.@..@.
@.....@@@.@@..@..@..
@@.@.@@@@..@.@@@...@
@@.@@@@@.@.@..@@.@@@
@....@......@@......
@@@.@.@@.@.@@.@.@@.@
@@@......@.@.....@@@
.@@.@@.@@@..@.@.@..@
.@.@.....@.@...@..@.
.....@.@..@.@.@@.@..
.@.@..@..@@........@
.@@..@@@..@.@.@.@.@.
@@@@..@@.@@@...@....
6
9 3 0
16 11 0
16 16 1
15 17 1
14 19 2
15 5 2

3 5 0
2 9 0
13 8 1
17 17 1
12 15 2
8 15 2
