width 20
height 20
.@..........@.@.@@@@
.@.@.@.@.@@@@.......
....@...@@.@..@.@@.@
@@.@.@.@....@@..@...
@@.@..@..@.@.@@..@.@
@....@@@..@.....@.@@
@@@@..@@@.@.@.@...@@
@....@.@.....@.@@..@
@@.@@...@.@.@..@@@..
@@..@@.@...@@.@@@@.@
@..@.@.@@@.@....@...
@@......@.@.@@.@.@.@
@.@@.@@.............
....@.@.@@.@.@.@.@.@
@.@.@..@.@..@..@@...
...@.@.@...@@@..@@.@
.@@......@.@@..@....
....@.@@..@@@@..@@.@
.@@..@@..@@@@.@...@.
..@.@@..@@@@....@...
6
1 17 0
9 5 0
12 19 1
8 1 1
4 1 2
9 3 2

6 14 0
13 12 0
14 17 1
18 2 1
18 17 2
14 5 2
