width 20
height 20
@@@.......@.@.@.....
@@..@.@.@.......@@.@
@.@..@@@..@@.@.@@@.@
...@..@..@@.@.@.@..@
@.@..@.@@........@.@
...@...@.@.@.@@.@.@.
@.@.@.@...@@@.......
........@.....@.@.@.
@.@.@.@.@@@.@..@@@@.
...@@.@@@.@..@.@@...
@.@@@@@@@..@@.@..@.@
@.@@@@@@..@....@..@@
...@@@@@.@.@.@..@.@@
@@..@@@....@@.@....@
...@.@.@.@......@.@@
@@........@.@@.@@@@@
...@.@.@.@@@@@@@@@@@
@@.@@..@@@@@@@@@@@@@
...@@.@@@@@@@@@@@@@@
@.@...@@@@@@@@@@@@@@
6
5 6 0
8 14 0
15 6 1
11 4 1
15 1 2
16 11 2

19 0 0
18 3 0
4 19 1
4 15 1
1 9 2
12 7 2
