width 20
height 20
@@@@................
@@@@................
@......@...@........
..........@...@.@...
..@.....@...........
...@................
....................
...@...@............
....@.@.....@.@.....
...............@....
..@....@.........@..
.............@......
....@...............
.................@..
..@.....@...@.......
..........@.....@...
....................
....................
.......@......@.....
................@...
1
13 5 0

1 14 0
