width 20
height 20
....................
.......@............
............@...@...
.............@...@..
.....@..............
.........@..........
.@.........@.....@..
...@....@....@....@.
....................
......@........@....
.@.....@@...........
.......@............
..@.@...............
................@...
..............@.....
@..@.@....@.@.......
.........@......@...
...................@
..@..........@@.....
.............@@.....
1
12 10 0

0 1 0
