width 20
height 20
@@@@@@@.....@@@@...@
...........@@@@@@...
...........@@.@@@...
....................
....@...@.....@....@
.....@.@....@.....@.
....................
............@.......
.....@....@......@..
@...................
@@..........@.......
@@..@@..............
@@......@...........
..@..........@......
......@...@.@.......
....................
....@...........@...
........@...@.@...@.
.@..@...............
........@@@.....@@..
1
2 16 0

7 8 0
