width 20
height 20
@@............@@....
@.........@.@..@....
@@..@...@...........
@@...............@..
@@......@.....@..@..
@..@.......@....@@..
....@...............
.............@......
........@..@........
....................
.........@..........
..............@.....
.....@........@...@.
.....@...@...@......
....................
..@.@...........@...
.........@..........
......@..@..@.@.....
.@@.................
@@@.................
1
9 9 0

7 8 0
