width 20
height 20
@....@...@....@...@@
.........@........@@
.............@....@@
..@................@
.@.....@............
..........@.........
.......@....@.......
....................
.@......@...........
.....@..............
..........@...@....@
..@...@....@........
.......@........@...
......@..@..@.......
....................
....................
....@....@......@...
..@..........@......
...........@..@....@
...................@
1
17 7 0

17 6 0
