width 20
height 20
................@...
.............@......
........@..@........
......@........@....
...........@......@.
.....@..............
......@.............
.......@....@..@....
....................
.................@..
......@...@........@
..@...........@.....
........@.@.........
..................@.
.....@@.......@.@...
..@.................
.........@...@......
....................
...........@.@......
...........@@@..@...
1
11 1 0

4 17 0
