width 20
height 20
@@.........@........
....................
......@.........@...
.............@@.....
.........@....@@....
.....@..............
......@..@..........
.....@.....@..@.....
...@......@....@....
................@...
..@.@.......@.......
....................
..@..@...@...@......
.......@...@.@......
.....@..@.@.........
....................
.....@.......@..@...
.........@..........
...@@..........@....
...@@@.@............
1
5 3 0

6 11 0
