width 20
height 20
....................
....................
.........@........@.
..@.................
@@.....@@....@......
...@................
....................
......@.....@...@...
..........@.........
.......@............
......@..........@..
@.............@@....
@.......@...@.@@..@.
......@.............
....................
.....@..............
..........@@........
.....@......@.......
..@.................
.......@.....@......
1
9 10 0

18 15 0
