width 20
height 20
@@...............@..
....................
....................
.....@..@.....@.....
...........@.....@.@
.@....@.............
..........@.@.......
...........@........
..........@.........
..@.................
..........@....@....
........@...........
....................
.............@.....@
...@......@...@....@
....................
......@......@......
..@......@..........
....................
.....@@@..........@@
1
18 7 0

14 10 0
