width 20
height 20
@@..................
@@@.................
@@@.....@...........
.......@........@@..
....................
..@......@@.........
...@.....@....@...@.
....................
@....@......@.@....@
.........@......@...
.....@.....@.@.@....
....@..@....@.......
....................
.@.......@........@.
......@.....@.......
...........@...@....
...@.@..@........@..
....................
.........@.........@
@@...........@@....@
1
14 7 0

14 7 0
