width 20
height 20
...............@@@@@
..@......@..@...@@@@
......@.........@@@@
..............@@@@@.
.........@..........
..@...@@............
....@...............
....................
........@...........
...............@....
.@..@.......@.@.....
...........@........
..............@.....
...@.....@.@........
......@.............
..............@..@..
...........@..@.....
@...........@..@....
@............@......
...................@
1
12 6 0

3 18 0
