width 20
height 20
...................@
......@...........@@
.............@.....@
............@......@
....@...............
.................@..
..........@......@..
.....@.......@......
.@....@..@..........
..@..............@..
...@...@.....@......
........@....@......
.....@.......@......
................@...
.........@.....@....
........@..........@
....................
...............@...@
.............@......
.@.............@@@@.
1
16 15 0

0 0 0
