width 20
height 20
@.............@@...@
@.@......@....@....@
....................
....................
....@........@......
..@...@..........@..
............@.......
...@..@.......@.....
........@...........
@................@..
.............@..@...
...........@.....@..
.....@...@...@.....@
.......@..........@@
..@........@..@.@..@
..............@.....
....................
....................
....................
....@....@.........@
1
12 17 0

5 5 0
