width 20
height 20
.......@@@..........
....................
..........@....@....
...@..@...@........@
....................
.........@...@......
....@...........@...
....................
..@......@.....@....
.@@@@...............
....................
@...........@.@.....
@....@..............
@......@...@..@.....
......@..........@..
..@.................
............@.......
........@.@.........
.@....@....@........
..............@.@...
1
4 13 0

19 6 0
