width 20
height 20
@@@.................
@@.@.......@........
...............@....
....................
.............@.@....
..................@.
...@.............@..
.....@...@..@@@.....
.......@.....@@.....
...@.........@@.....
........@..........@
....@.....@.....@.@@
.......@......@...@@
....@......@........
....@............@..
@@......@...@.......
@@@@....@...........
@@@@@.....@.........
@@@@....@...@......@
@@@@..............@@
1
6 2 0

10 18 0
