width 20
height 20
.@@@@...@@@@@@...@..
..@@@@.@@@@@.@.@...@
.@..@@..@@@.....@.@.
.@.@.@.@@@.@@@.@.@..
........@.........@.
@.@.@@.@.@.@.@.@.@@.
..@@@.......@@..@@..
.@..@@.@.@.@...@@@@.
@..@.@@.@.@..@.@@@..
@@....@.@.@@..@.@.@.
@.@@.@.......@@.....
.......@.@.@.@@@@.@@
.@.@.@.@@@@@@.@.@...
..@...@..@.@@.....@.
.@@@.@.@......@.@@@@
@......@.@.@.@@@@@@@
.@.@.@....@@@@@@@@@@
....@..@@@@@@@@@@@@@
.@.@@@@@@@@@@@@@@@@@
..@@@@@@@@@@@@@@@@@@
5
0 14 0
17 12 0
1 6 0
12 1 0
15 9 0

4 4 0
5 17 0
2 3 0
12 14 0
8 16 0
