width 20
height 20
@@@..@@@@@@.@@@@...@
@@@@..@@@@..@@@@@.@@
@@@@.@@@..@...@.@.@@
@.@...@@.@@.@......@
..@.@.@..@.@.@.@.@..
@..@..@@.....@.@@@@.
.@..@..@.@.@..@..@..
...@.@.@@@@.@...@.@.
.@.......@@...@.....
@..@.@.@.@@@.@..@.@@
..@@@..@.@@@..@..@@@
.@.@..@.@.@..@..@@@@
@....@......@..@.@.@
..@@...@.@.@@@......
.@...@.@..@@@..@@@.@
.@@.@.@@@@@@@@....@@
..@...@@@@@@@@@.@..@
@..@@.@@@@@@@@@@..@@
@.@@@@@@@@@@@@@@@.@@
@@@@@@@@@@@@@@@@..@@
5
11 1 0
18 3 0
17 19 0
14 11 0
18 4 0

12 6 0
10 12 0
17 19 0
15 11 0
11 11 0
