width 20
height 20
@.@.@@...@.@.@.@@@@.
.......@@......@@@..
@.@.@.@..@@.@@@@@.@.
@.@@.@@@.@...@.@....
...@.......@....@.@@
.@@..@.@@.@@@@@.....
..@.@@@....@@@@.@.@.
.@@@.@.@@.@@@@@@...@
..@@......@@@@@.@.@.
.@.@.@.@.@@@@@......
......@.@@@@@@@.@.@@
.@.@.@..@@@@@@@@@@.@
..@@@@.@.@@@@@@@@...
.@........@@@@@@@@.@
..@@.@@@.@.@@@@.@...
.@@.@@...........@.@
....@@@.@@@.@.@.@...
.@@.@@.@@@@.@.@...@.
@.@.......@@.@.@@..@
....@.@.@.........@@
5
14 3 0
8 14 0
14 15 0
8 9 0
9 19 0

17 17 0
19 12 0
18 12 0
7 8 0
9 19 0
