width 20
height 20
...@@@@..@.@@@.@.@.@
@@.@@@@@....@.......
.....@@@.@@@.@.@@@.@
@.@.@.@...@.......@@
@..@....@@.@.@.@.@.@
..@.@.@.......@@.@.@
@......@@.@.@@..@...
..@.@.@@@@.@.@.@.@.@
@..@@@@@@@..........
..@.@.@.@.@.@@.@@.@.
@............@...@..
@.@.@@.@@@.@@@.@..@.
.@...@@...@.@@@..@..
..@.@@@@.@@..@@@.@@.
.@.@..@....@..@....@
.....@.@.@@.@.@@.@..
.@.@.@..........@..@
..@....@@@.@@@@@.@.@
@.@@.@...@.@.@.@...@
@@@..@.@@........@..
5
3 13 0
13 14 0
9 19 0
16 15 0
15 19 0

0 13 0
16 8 0
15 14 0
9 3 0
18 1 0
