width 20
height 20
@@.@....@@@@@....@@.
.@..@@@..@@@@@.@....
...@.@@.@@.@@.@@@.@.
.@.@...........@@@..
@....@.@@@.@.@@@@@@.
@@@@..@....@@@@@@@@.
@@@@.@..@.@.@.@@@@@.
@@@@@..@.......@@@..
@@@@@@.@.@.@@.@@@.@.
@@@@.@@.@@.@@..@....
@.@@.@....@...@@@.@.
......@@@..@.@.@..@.
.@.@@.@.@.@@.....@.@
..@@.......@.@.@....
@...@.@.@.@..@@.@@.@
@.@..@@@....@.......
.@..@@@@@@@..@.@.@.@
...@@@@@@@.@..@@@..@
@.@@@@@@@....@@@@@.@
..@@@@@@@@.@.@@@@@@@
5
3 15 0
16 13 0
19 10 0
16 11 0
3 11 0

15 12 0
1 17 0
8 8 0
13 6 0
15 0 0
