width 20
height 20
@@@.@@.@@@.@@@@@@.@@
@@@.....@....@@@...@
.@.@@@.@.@.@..@..@..
.@..........@..@.@.@
...@@.@@@@.@@@@..@.@
.@.@@@..@.@.@.@.@.@@
@...@.@...........@@
..@.....@.@.@.@.@..@
.@@@.@.@.@...@@@@@..
.@@@@.....@.@@@@@..@
@@@..@.@.@...@.@.@..
@@@.@.@..@@.@@...@.@
@@@.@...@@@..@.@....
@@@...@...@.@..@.@.@
@@@@@.@.@.@@.@..@@@@
@@@@@..@@@.....@@@@@
@@@.@@..@..@.@@@@@@@
@@.....@.@@..@@@@@@@
@@.@.@...@@@.@@@@@@@
@@@..@@.@@@...@@@@@@
5
6 17 0
6 0 0
4 7 0
18 12 0
9 3 0

5 7 0
6 8 0
4 7 0
12 16 0
13 7 0
