width 20
height 20
@@@@@.@@@@@@@..@..@.
@@@@..@.@@@@@.@.@.@.
@@@.@.@.@@.@........
@@......@@..@.@.@@.@
@.@.@.@...@....@@@..
....@@..@...@@@.@@.@
@.@@@.@.@.@.@@..@...
...@...@.@..@..@..@@
@.@.@.@..@@.@@...@@@
........@@....@@.@@@
.@.@.@@.@.@@@@..@.@@
..@@.@@........@...@
.@...@@@.@.@.@...@@@
.@@@..@.@@@.@.@@.@.@
.@...@..............
@.@@@.@.@@.@.@.@.@@.
....@.@.@.@@@.@.@...
@.@........@......@.
@@@@.@@.@.@@.@.@@@.@
@@@@@@@@....@......@
5
14 12 0
7 15 0
0 13 0
13 14 0
15 1 0

10 11 0
11 6 0
3 12 0
4 13 0
0 7 0
