width 20
height 20
.@.@.@..@.@.@.@.@.@.
......@...........@.
@.@.@@@.@.@@@.@.@...
..@@@@@@..@.@.@.@@.@
@.@@@@@@@....@.@@@..
....@.@@@@@.@..@@..@
@.@....@@.@..@..@@@@
..@.@@.@..@.@..@.@@@
.@.@@.@.@....@.@..@@
..........@.@@...@@@
.@.@@@.@@@.....@.@.@
.@@@@@@...@.@.@.@...
...@@.@.@@.@@.@..@.@
@@@.@..........@....
@.@.@@.@@.@.@.@.@.@.
.........@.@.@@..@..
.@.@.@.@......@.@.@.
@@.@@.@..@@.@.......
@......@...@..@.@.@.
..@.@.@@@.@..@..@.@.
5
17 2 0
8 1 0
13 17 0
11 10 0
12 15 0

19 2 0
16 15 0
1 2 0
14 7 0
2 18 0
