width 20
height 20
.@.@......@@@@@@@@@@
....@.@@.@@@@@@@@@@@
@.@..@....@@@@@@@@@@
..@.@.@.@@@@@@@@@@@@
.@.@.......@@@.@@@@@
....@.@@.@..@...@@@@
.@.@.@.@@..@.@.@.@@@
@.........@.......@@
..@@@.@.@.@@@.@@.@.@
@....@@@...@@.@.....
..@.@@@.@.@.@..@@@@.
.@@..@........@@@@..
@@.@.@.@.@@@.@..@.@.
...@@@@@@@.@@.@...@.
@.@@.@.@.@......@.@.
...........@@.@@....
@.@.@.@.@.@.....@.@.
..@@.@@..@..@.@..@..
.@......@@@.@@..@@@.
.@.@@@.@@@....@..@@@
5
19 14 0
7 18 0
6 0 0
8 17 0
13 9 0

4 11 0
4 7 0
17 12 0
1 15 0
19 14 0
