width 20
height 20
@@@@@@@@@@@@@@@@@@@@
@@@@@@@@@@@@@@@@@@@@
@@@@@@@@@@@@@@@@@@@@
@@@@@@@@@@@@@@@@@@@@
@@@@@@.@@@@@@@@@@@@@
@@@@@@..@@@@@@@@@@@@
@@@@@@.@.@@@@@@@@@@@
@@@@.@....@@@@@@@@@@
@@@....@@.@@@@@@@@@@
@...@.@.@.@.@@@@@@@@
@.@.@@......@@@@@@@@
...@..@.@@.@@@@@@@@@
@.@@.@...@.@@@@@@@@@
..@....@@@@@@@@@@@@@
@@@@.@...@.@@@@@@@@@
@@@@@..@....@@@@@@@@
@@@@..@.@@.@@@@@@@@@
@@.@@.@.@.@.@@@@@@@@
............@@@@@@@@
@.@.@.@@.@.@@@@@@@@@
5
9 15 0
6 4 0
10 14 0
8 10 0
1 9 0

11 17 0
10 15 0
6 10 0
5 17 0
9 8 0
