width 20
height 20
@@...@@@@........@@@
@@@@..@@..@.@.@@@@@@
@@...@.@@..@..@.@@@@
@@.@......@@@...@@@@
@..@.@.@.@..@@@.@.@@
..@@@.@@.@.@..@@...@
.@@.@.@.@....@.@.@@@
........@@.@......@@
.@@@.@.@.@@.@@@@.@.@
@@@@@........@.@....
.@@@@@.@.@.@.....@.@
..@@@.@.@@..@.@.@@.@
.@.@.......@@@.@....
.@...@.@.@.@@@...@.@
...@..@.@...@@@.@@.@
.@@@@@..@@.@@@@..@@.
.@.@.@.@@@@@@.@.@...
.@......@@.@......@.
...@@.@.....@.@.@.@@
.@..@@..@.@.@@...@@@
5
3 17 0
15 10 0
5 17 0
10 4 0
6 15 0

6 9 0
9 14 0
13 10 0
9 18 0
6 15 0
