width 20
height 20
@@@@@@.....@...@.@@@
@@@@@@@.@.@..@....@@
@@@@@@.@..@.@@.@.@.@
@@@@@...@.@...@@@..@
@@@@@@.@....@@@@.@.@
@@@@@....@@.@.@..@.@
@.@@@@@@.@.@....@...
...@@.@@....@.@@.@.@
@.@....@@.@.........
..@@.@..@@..@.@@.@.@
@..@.@.@.@@..@@.@.@@
@.@.@.......@.@...@.
......@.@.@.....@.@.
@.@@@..@.@.@.@.@....
...@.@......@@@.@.@.
@.@..@.@.@.@@@.....@
@..@..@.@@@@@.@.@.@@
..@.@....@.......@@@
@.....@.@@@.@.@.@.@@
@.@.@@...@..@@.....@
5
16 13 0
12 12 0
12 10 0
1 9 0
17 15 0

11 2 0
7 12 0
13 18 0
5 11 0
8 2 0
