width 20
height 20
.@..@..@@@@@@..@@@@@
.@.@.@...@@@..@@@@@@
.....@.@.@@.@..@@@@@
@@.@..@.......@@@@@@
@@..@..@.@@.@@@@@@@@
.@.@.@@....@..@..@@.
.....@.@.@..@...@@@.
.@.@....@..@@@@.@@..
@.@.@@.@.@..@.@.@.@.
@........@@.........
@.@@.@.@..@.@@.@@.@@
...@@@@@@..@@@@...@.
@.@..@@@..@.@@..@.@.
....@.@..@.....@@@..
@.@....@.@@.@.@@@.@.
@@.@@.@.@.@..@..@...
......@.....@.@...@.
@@.@@.@.@.@...@.@@..
...@....@@.@@....@@.
@.@@@@@......@.@@@..
5
3 4 0
14 9 0
4 3 0
16 9 0
3 12 0

3 14 0
19 14 0
12 1 0
1 16 0
15 11 0
