width 20
height 20
@@.@..@@@@@@@@@@@.@@
@@...@...@@@@@@@...@
@@.@@.@.@.@@@@@@@.@@
@@......@.@.@.@@@...
@@@.@.@@@...@.....@.
@@...@.@.@.@..@.@@..
@.@.@@.....@.@.@.@@.
......@@.@@........@
.@@.@......@.@.@.@..
.@@@@.@.@.@@.@..@@.@
@@@..@@@..@@.@@@@@..
@..@.@@.@.@.@.@.@..@
@@...............@.@
@..@.@.@@.@@.@.@....
@@.@@....@..@.@..@.@
@@@@.@.@...@....@...
@@@..@.@.@.@@@.@.@.@
@@@@...@@@....@.....
@@@@@.@....@.@.@.@.@
@@@@@@@@.@.@...@..@@
5
13 5 0
13 7 0
17 15 0
4 16 0
9 13 0

18 8 0
7 6 0
13 12 0
10 5 0
2 12 0
