width 20
height 20
.@.@@@.@......@..@@@
.@..@...@.@@.@.@.@.@
...@@.@.@@@.........
.@...@...@@@.@.@.@@.
@..@@@@@.@..@...@...
..@.@@.....@.@.@@@.@
@......@.@........@@
..@.@.@@@..@@@.@.@@@
@..@@@@@@@@@@@@....@
..@@@@@@@@@@@@@@.@..
.@@@@@@@@@@@@@@@@..@
@@@@@@@@@@@@@@@@@@@@
@@@@@@@@@@@@@@@@@@@@
@@@@@@@@@@@@@@@@@@@@
@@@@@@@@@@@@@@@@@@@@
@@@@@@@@@@@@@@@@@@@@
@@@@@@@@@@@@@@@@@@@@
@@@@@@@@@@@@@@@@@@@@
@@@@@@@@@@@@@@@@@@@@
@@@@@@@@@@@@@@@@@@@@
5
18 10 0
1 5 0
14 5 0
0 9 0
15 2 0

18 10 0
5 1 0
6 0 0
12 2 0
2 6 0
