width 20
height 20
@@....@.@.@.@....@..
@.@.@.........@@.@.@
...@.@.@.@.@@.@.....
@@.@...@@.@..@.@.@.@
...@@@......@...@..@
.@...@@@.@@.@@@.@@..
..@.@@@.@.@@@......@
.@.@.@....@.@.@@.@.@
......@.@@.....@..@@
@.@@@......@@.@@@..@
@@...@@.@@@@.@.@.@@.
@.@@.....@........@.
....@.@.@.@.@.@@.@..
@.@..@..@..@....@.@.
...@.@@.@.@.@.@@....
@.@...@..........@.@
@@@@@...@@@.@@@.@...
@@@@@.@@.......@.@.@
@@@@@@@@@.@.@.@.....
@@@@@@@@...@...@@@@.
5
4 13 0
13 7 0
9 17 0
14 3 0
15 15 0

11 0 0
1 14 0
5 3 0
0 8 0
16 11 0
