width 20
height 20
.@.@.@@@@@@@@@@@...@
......@@@@@@@.@.@.@@
.@@@@@@@@@@@.......@
.@.@....@.@@.@.@.@.@
....@.@@....@...@...
@@.@.....@.@@.@@.@.@
@....@@@.@@@@@.@....
.@.@.@...@..@....@.@
....@@@.@.@.@@.@..@@
.@.@@@.......@..@@@@
..@..@@@.@@.@@.@.@@.
.@@.@.@.@...@.......
.........@@..@.@.@.@
.@.@.@@.@@@.@...@@@@
..@@@@...@....@@.@@@
@@.@..@@..@.@.@...@.
....@.@.@..@@@@.@@..
@.@.@.....@.@.@.@.@.
@@....@.@...........
@..@@..@@@.@.@@@.@@.
5
0 12 0
10 7 0
16 5 0
13 14 0
18 11 0

3 6 0
10 9 0
3 1 0
7 14 0
9 15 0
