width 20
height 20
@@.@@@...........@@@
@...@@@.@@@.@.@@....
.@.@.@.@.@@..@...@@@
...........@..@.@@.@
.@.@.@@@.@@.@@......
..@@@..@..@.@.@@.@.@
@.@@@@...@......@...
..@@@..@@.@.@@.@.@.@
@@.@.@..@..@@@...@.@
.......@.@..@@.@...@
@.@@.@....@...@@@.@.
...@.@@.@...@@.@@...
@.@.@.@@.@@@.@....@.
...............@.@@@
.@.@.@.@@.@@.@..@@@@
.@.@@.@..@..@@.@@@@@
@.......@..@@@@@@@@@
@@.@@.@.@.@@@@@@@@@@
@@...@.....@@@@@@@@@
@..@@@.@@.@@@@@@@@@@
5
7 6 0
6 19 0
10 0 0
16 13 0
11 9 0

9 11 0
4 10 0
17 12 0
5 12 0
1 6 0
