width 20
height 20
....@@@@@@.@.@......
@.@..@@@@......@.@.@
.@.@.@.@.@.@.@.@@...
...........@@..@@@.@
.@@.@.@.@.@.@.@.@...
..@@.@@@....@....@.@
.@.@.@@@@.@@.@.@.@..
.......@.@.....@@..@
.@.@.@@...@.@@.@@@@@
..@..@@@.@@...@@.@.@
.@@@..@....@.@......
..@@.@@@.@....@@.@.@
.@@.@.@..@@.@.@...@@
@......@@.@@@...@@..
@@.@.@........@.@.@.
@@@.@..@.@.@.@....@.
@@....@.@...@.@.@...
@@@.@...@.@@.....@.@
@@@..@.@.@@@@.@.@@..
@@@.@.....@@@@...@.@
5
3 13 0
6 3 0
14 8 0
16 11 0
17 2 0

14 15 0
18 7 0
1 3 0
13 13 0
4 8 0
