width 20
height 20
@@@@@@@@@@@..@@..@.@
@@@@.@@@@@@.@...@...
@@@...@.......@@.@.@
@@.@.@@@.@.@.@.@.@..
@.....@@@@@........@
.@.@.@@@@@@@.@.@.@.@
....@.@...@@@...@@@.
@.@@....@..@@@@..@..
..@@@.@.@.@@@@..@@@.
.@.@@@...@@@@.@.....
....@.@.@@@@....@@@@
.@@.....@@@.@.@.@@..
.@..@@.@@.....@@@@.@
@.@..@@@..@.@.@.@...
....@.@.@..@@@...@@.
@.@@@...@.@.@.@.@@@.
..@.@.@.............
@....@@.@.@.@.@@.@.@
@@.@.....@@@@...@..@
...@@.@.@.....@.@.@@
5
14 5 0
7 10 0
16 4 0
17 1 0
9 12 0

12 2 0
14 6 0
3 12 0
15 7 0
5 8 0
