width 20
height 20
@@.@....@.@.@@.....@
@...@.@......@.@@.@.
..@..@@.@.@.@..@....
.@.@@..@.@....@@@.@.
......@...@.@.@@@@..
@.@.@..@.@.@...@@.@@
...@.@.....@@.@.....
@@....@@@@.@@...@.@.
..@.@.@....@@.@..@@.
.@.@...@@.@@@@..@..@
...@@.@...@@@@.@..@.
.@.@...@.@@@@@..@...
@....@@@@.@@@..@@.@.
..@@.@@@@..@..@.@..@
@...@..@..@.@.....@@
.@.@@.@.@.@...@@.@@@
...@........@...@@@@
@@...@@@.@.@..@@@@@@
@..@.@@@@..@.@@@@@@@
@@.@@@@@@@.@@@@@@@@@
5
0 4 0
3 17 0
4 6 0
19 3 0
9 1 0

5 0 0
18 4 0
4 7 0
13 2 0
14 0 0
