width 20
height 20
@@@@@..@@@.@..@.@@@@
@.@.@.@.@@.@@....@@@
@.@.@.......@.@@.@@@
......@.@.@..@@...@@
.@.@.@...@@@.@@.@@@@
..@...@.@.@.@.@...@@
@.@@.@....@.....@@.@
@@@@@@@.@...@.@..@..
@@@@@@@..@@@.@.@...@
@@@@@@@@..@......@..
@@@@@@@@.@@.@@.@@..@
@@@@@@@@@@@@..@@.@..
@@@@@@@@@..@@.@....@
@@@@@@@@..@.@.@@.@..
@@@@@@@@@......@..@@
@@@@.@@@@.@@.@.@.@@@
@@@....@...@@.....@@
@@@@.@.@@.@.@@.@.@@@
@@@@@........@@.@@@@
@@@@@@.@.@.@.....@@@
5
12 3 0
5 16 0
11 10 0
4 4 0
7 2 0

11 13 0
6 16 0
7 3 0
8 19 0
9 12 0
