width 20
height 20
@@.@.@@@@@@@@@@@@@@@
@......@@@@@@@@@@@@@
@@.@.@..@@@@@@@@@@@@
.@.@@.@.@@@.@.@.@@@@
..@..............@@@
.@.@.@.@.@@@.@@.@@@@
.@.@..@@.@@.@....@@@
....@.@.@....@.@@.@@
.@.@....@@.@....@.@@
@....@@.@@.@.@@@....
@@.@@@..@.@.@.@.@.@@
@.@.@@@.............
....@@.@.@.@.@@.@.@@
.@@.......@@...@@@@@
..@.@.@@.@...@@@@@@@
.@@@@...@..@@.@@..@@
..@...@.@@.......@@@
.@..@@..@@.@@.@.@.@@
.@.@@@@.@@..@@....@.
@@@@@@@@...@@@@.@...
5
10 17 0
13 6 0
12 13 0
15 18 0
15 3 0

14 4 0
9 10 0
9 7 0
13 8 0
4 9 0
