width 20
height 20
.........@@.@.@@@@..
.@.@.@.@.......@@@.@
..@..@@.@.@.@.@@@...
@.@@.@....@..@@@.@.@
@..@@.@.@@.@.@@.....
@@@........@.@.@.@.@
@@@@.@.@@.@......@..
@.@.@@..@..@.@@.@@@.
@.@....@.@.@@..@.@..
....@.@.....@.@....@
@.@.@@.@.@.@@.@@.@.@
...@@.....@......@@@
@.@..@.@.@..@@@@..@.
...@..@@@@@..@@.@@..
@.@.@.@.@@..@.@.@..@
..........@...@..@..
@.@.@.@.@@..@...@..@
@@...@@...@@.@.@.@..
@.@.@...@..@...@.@.@
.....@@..@@..@......
5
10 8 0
15 6 0
14 17 0
1 4 0
2 17 0

11 19 0
17 2 0
13 16 0
18 2 0
16 12 0
