width 20
height 20
@@..@..@@@..@.@.@.@@
@.@.@.@.@..@@.......
.........@..@.@.@.@.
@@.@.@.@@..@...@.@.@
...@@.....@.@@......
@.@.@@@.@......@.@.@
@@...@@@..@@.@@@@..@
@.@.@@@@@.@@.@@@.@..
.....@@@@@.@@......@
@.@@@.@@@.....@.@.@.
...@@..@..@@.@@@....
@.@.@.@.@.@.@@@@@.@.
.............@@@@@@@
.@.@@.@.@.@.@..@@@@@
..@....@@@....@@@@@@
.@@@@.@@@..@@..@@@@@
@@@...@@.@.@..@@@@@@
@@.@.@....@.@.@@@@@@
@.....@.@.......@@@@
@@.@.@@.@.@.@.@.@@@@
8
1 10 0
5 13 0
11 14 0
17 11 0
4 12 0
9 3 0
12 7 0
13 5 0

1 4 0
19 11 0
0 4 0
11 18 0
13 1 0
10 3 0
10 12 0
4 12 0
