width 20
height 20
.......@@.@@@@@.@@@.
.@.@.@......@....@..
..@.@@.@.@.@.@@.@@@.
@@.....@..@...@..@..
@@@.@@@.@@..@...@@@.
@@......@.@..@.@@...
@..@.@@...@.@..@.@@.
..@@@...@.@.@@......
@@.@.@.@@.@.@@@.@.@@
........@....@.@@.@@
.@.@.@.@@.@.@@..@.@@
..@@@@.@.@@.@.@.@...
.@.@.@@....@....@.@.
.....@@@.@.@.@@.@@..
@.@.@.@.@..@.@...@@.
@@@.......@@@@@.@.@.
@@@.@.@.@.@..@......
@@...@..@@@@.@@.@.@.
@@@.@@@.@.@......@@@
@@@@@@@@....@@@.@@@@
8
6 5 0
5 7 0
13 11 0
5 5 0
14 16 0
15 16 0
6 8 0
11 1 0

19 12 0
11 5 0
16 16 0
4 6 0
7 15 0
18 11 0
9 10 0
2 6 0
