width 20
height 20
.......@@.@@@@@@@@.@
@@.@@.@....@@@@@@@..
@...@.@@.@..@@@@@..@
@@.@...@@..@@@@@.@..
..@@@@....@..@@..@.@
@..@...@.@.@.@.@.@.@
@.@@.@@.............
......@@.@@@.@@.@.@.
@.@.@@@...@...@@..@@
...@.@.@.@.@.@.@@..@
@.@@........@..@@.@.
.@@@.@.@@.@@@@.@....
.@@...@@@@@@@@..@.@.
..@@.@....@@@@@..@..
.@.....@.@.@@@..@..@
...@.@.@....@..@.@..
.@..@@@.@@.@.@....@.
..@..@@.......@@.@.@
@@..@@.@.@.@.@......
@@@.....@@@....@.@@.
8
19 19 0
11 10 0
9 0 0
5 5 0
16 18 0
4 3 0
18 2 0
4 6 0

7 19 0
1 13 0
13 10 0
12 17 0
2 16 0
12 9 0
15 13 0
19 13 0
