width 20
height 20
@@@@@@@@@@@@@@@...@.
@@@@@@@@@@@@@@@@@...
@@@@@@@@@@@@@@@@@.@.
@@@@@@@@@@@@@@@@@..@
@@@@@@@@@@@@@@@@@.@@
@@@@@@@@@@@@@@.@@..@
@@@@@@@@@@@@@@....@@
@@@@@@@@@@@@@..@.@.@
@@@@@@@@@@.@@@.@....
.@@@@@@@@@.@..@..@@@
.@@@@@@@.@.@.@.@..@@
..@@@..@.........@.@
.@.@.@...@@.@.@.@@..
.......@..@@...@@..@
@.@.@.@..@@..@@.@@.@
...@@@..@@@@.@...@..
@.@@@@@...@.@.@.@@.@
..@@@@@@@........@..
.@.@@@@@..@.@@.@...@
....@@@@@..@....@.@@
8
19 15 0
19 0 0
8 10 0
16 0 0
17 1 0
10 17 0
0 9 0
8 11 0

9 17 0
12 9 0
18 5 0
10 8 0
12 11 0
19 1 0
1 13 0
8 14 0
