width 20
height 20
@@@@@@@@@@@@@@@....@
@@@@@@@..@@@@@.@.@.@
@@@@@@@@..@@@...@...
@@@@@@@@.@.@.@.@.@.@
@@@@@@@.............
@@.@.@@.@@.@.@.@.@.@
@@....@...@.@@..@.@@
@..@.@@@.@@.@@@@..@@
@@.@@.@.........@..@
.......@@.@.@.@@.@..
@.@.@@.@@..@@......@
@@@@@.....@@@@.@.@.@
@@@@@@@.@.@@@@@.@..@
@@@......@@@@...@@.@
@@@@@.@.@@@..@.@.@.@
@@@@@..@.@..@.......
@@@@@@...@@..@.@.@@.
@@@@@..@..@.@...@.@.
@@@@@@.@.@...@@@....
@@@@@@.@...@..@@@.@.
8
7 14 0
18 10 0
18 5 0
17 8 0
14 4 0
4 9 0
15 0 0
13 4 0

7 4 0
15 6 0
8 6 0
10 10 0
1 7 0
5 9 0
9 19 0
8 2 0
