width 20
height 20
.@.....@@@@.@@......
.@.@@@@.@...@@.@.@.@
...@..@...@...@@.@..
.@...@.@.@@@@..@..@.
..@@.....@@@@@.@.@.@
@...@.@@.@.@@.......
@@.@..@.@@.@@@.@.@.@
@.@.@.......@...@...
......@.@.@.@@@@.@.@
.@.@@..@...@.@@....@
..@...@@@.@..@.@.@.@
.@@.@....@.@.@....@@
@@@@@@.@@@...@.@.@@@
@@@@@..@@..@....@@@@
@@@@.@...@@..@.@@@@@
@@@@...@...@@...@@@@
@@@@@@@..@@@@@.@@@@@
@@@@@..@...@@@@@@@@@
@@@@@@..@.@@@@@@@@@@
@@@@@@@.....@@@@@@@@
8
8 2 0
10 15 0
4 10 0
0 10 0
6 3 0
7 1 0
14 6 0
6 13 0

8 2 0
8 11 0
14 11 0
12 9 0
9 13 0
8 19 0
10 7 0
12 11 0
