width 20
height 20
@@@@@@@@@@@@@@@@@@@@
@@@@@@@@@@@@@@@@@@@@
@@@@@@@@@@@@@@@@@@@@
@@@@@@@@@@.@@@@@@@@@
@@@@@@@@@..@@@@@@@@@
@@@@@@@@@@..@@@@@@.@
@@@.@@@.@..@.@@@@...
@@...@...@....@..@.@
@.@.@.@.@.@@.@.@....
.................@.@
.@.@@@.@.@@@.@.@.@..
..@..@@.....@.@@@..@
.@.@...@.@@...@@@@..
...@.@..@@.@@@@@...@
@.@@@.@.....@.@.@.@@
@@......@@@........@
@@.@.@@...@.@.@.@.@@
@...@...@..@@@@@....
@@.@..@.@@@@@@@@@.@.
@@@@@..@@@@@@@@@@@@@
8
10 6 0
7 9 0
10 9 0
9 8 0
6 12 0
18 6 0
7 13 0
2 18 0

7 18 0
11 15 0
17 15 0
9 8 0
9 14 0
18 13 0
3 9 0
18 9 0
