width 20
height 20
@@@@..@@..@@....@@@.
@.@@@...@..@@.@@@@..
......@@@.@.@.@.@.@.
.@@.@..@............
...@@@...@@.@.@.@.@@
.@@@@..@...@.@.@@...
.....@@..@.....@..@.
@.@@@@@@..@.@.@.@.@@
.@.@.@@@.@..@@@.....
.@.....@@.@@@.@.@@.@
.@@@.@...........@.@
......@.@.@.@.@.@@@@
.@@.@@.@@@.@@@..@.@@
...@........@.@....@
.@.@.@.@@.@.....@@@@
@...@...@..@.@.@@@@@
@@.@.@.@@.@.@.@.@@@@
@@@.....@........@@@
@@..@.@.@@.@.@.@@@@@
...@@@@@@@@..@...@@@
8
0 10 0
7 13 0
3 9 0
14 15 0
2 13 0
5 13 0
9 3 0
7 6 0

10 10 0
12 5 0
3 12 0
11 14 0
5 13 0
3 18 0
11 10 0
0 12 0
