width 20
height 20
..@..@..@@@.@.@@@@@@
.@..@.@...@....@.@@@
.@@.@...@.@@@.@....@
......@@.@@@...@.@@.
.@.@.@.@.@@.@@....@.
..@@@..........@.@@.
.@.@.@.@@.@.@@.@....
........@.@.@.@@@@@.
@@.@.@.@.@.....@.@..
@..@@@@....@.@....@.
@@...@@@.@.@@.@@.@.@
@@.@.@@...@.........
.@@..@.@@@..@.@.@.@.
.@@@.@.@.@@..@.@.@@.
.@@..@......@.......
...@@@.@.@.@@@.@.@.@
@.@..@..@...@..@@@@@
....@@.@.@@@.@@@.@.@
@.@.@...............
@@....@.@.@.@.@.@@.@
8
19 14 0
1 9 0
3 10 0
4 13 0
16 10 0
7 1 0
2 7 0
8 9 0

19 14 0
12 17 0
9 14 0
11 19 0
6 12 0
9 18 0
6 15 0
0 15 0
