width 20
height 20
.@.@@@@..@.@...@.@@@
...@@@.@....@.@...@.
.@@.@...@.@@....@...
.....@.@..@@@.@..@.@
@@@.@....@.@..@.@.@.
......@@.....@......
@.@.@..@.@.@.@@.@.@.
@@..@.@...@@.@...@.@
..@..@.@@@....@.@@..
@...@......@.@@@@.@.
..@.@@@@.@.@..@.....
@..@.@@@..@.@@.@.@@@
.@.....@.@..@.......
...@.@@@.@.@.@.@@.@.
@.@..@.@.......@..@@
...@....@@@.@.@.@.@.
@.@@@.@.@....@....@.
@..@@@...@@.@.@.@...
..@@@.@@.@.....@..@@
@..@.....@.@@.@@@...
8
16 14 0
17 10 0
5 7 0
2 11 0
9 2 0
10 12 0
3 14 0
18 12 0

12 6 0
11 12 0
13 19 0
19 8 0
18 10 0
19 6 0
12 10 0
15 16 0
