width 20
height 20
@@@@@@@@@@@@@@@@@@@@
@@@@@@@@@@@@@@@@@@@@
@@@@@@@@@@@@@@@@@@@@
@@@@@@@@@@@@@@@@@@@@
@@@@@@@@@@@@@@@@@@@@
@@@@@@@@@@@@@@@@@@@@
@@@@@@@@@@@@@@@@@@@@
@@@@@@@@@@@@@@@@@@@@
@@@@@@.@@@@@@@@@@@@@
@@@@@...@@@@.@@@@@@@
@@@@.@.@.@@...@@@@@@
@@@......@.@.@.@@@@@
@@@.@.@@........@@@@
@@@@..@.@@.@.@.@@@@@
@.@.@.@...@...@@@@@@
......@.@..@.@.@@@@@
.@.@.@...@.@....@@@@
..@..@@.@.@@.@.@@@@@
.@@@.@........@@@@@@
@@@@@@@.@@.@.@@@@@@@
8
8 10 0
5 11 0
2 16 0
14 12 0
12 14 0
1 14 0
8 11 0
6 18 0

12 12 0
4 16 0
7 14 0
3 15 0
5 12 0
12 18 0
3 14 0
7 18 0
