width 20
height 20
..@.@.@.@.........@.
@.........@.@.@@@...
.@.@.@.@.@..@@....@.
...@..@.@@@.@..@.@..
@.@.@....@...@.@@.@.
@@@.@.@.@@@.@...@...
@....@@@@@@@@@@@..@@
@@@.@.@.@.@@@.@.@.@.
@.@.....@..@........
..@.@.@...@@@.@.@.@.
.@.@...@.@@@...@.@..
....@.@.@@..@@.@...@
.@.@......@.....@@..
.@...@.@.@..@.@@@@@.
..@.@...@@.@.@.@.@.@
@.@.@@.@@..........@
...@@.@.@.@.@@.@.@..
@.@.@.@....@.@@.@.@.
........@.@@........
@@.@@@@..@...@.@.@.@
8
6 15 0
5 8 0
9 0 0
17 9 0
6 4 0
16 3 0
3 5 0
12 10 0

13 9 0
7 16 0
5 8 0
15 0 0
13 5 0
12 19 0
8 1 0
18 16 0
