width 20
height 20
@@.@@@...@@@@...@.@.
@@..@..@@@@@..@.....
@@@...@@@.@.@..@.@@.
@@..@.@.@...@.@@@...
@.@.@@....@....@..@.
.......@@..@.@.@.@..
@.@@@.@.@.@.@.@.@..@
@@.@.@...........@@.
.......@.@.@.@@.@.@.
.@.@.@@.@.@@@.......
..@.@.....@@@.@@@.@.
@.....@.@..@.@.@.@.@
@@@.@.@.@.@........@
.@.@.@.@@.@.@@.@.@..
.....@....@...@...@@
.@.@...@.@.@@..@.@..
@...@.@@@...@.@....@
@@.@.@.@.@.@.@.@.@@@
..................@@
@@.@.@@.@@.@.@@.@..@
8
1 4 0
8 0 0
7 11 0
13 16 0
14 2 0
0 5 0
19 13 0
5 18 0

5 6 0
9 7 0
6 18 0
7 12 0
11 14 0
11 12 0
16 12 0
19 9 0
