width 20
height 20
..@..@...@@@@@.@.@..
@.@.@.@@..@@@......@
.........@.@..@.@.@@
.@@.@.@.@...@.@.@@@@
@@@..@@@@.@.@..@@@..
.@..@@@...@.@@.@@..@
..@.@@.@@.@@...@.@.@
.@...........@.@.@.@
...@@.@@.@@.@.......
@@...@.....@.@.@@.@.
@..@@@@.@.@.....@@..
@@..@@.@.@@@.@.@..@.
@@.@@.........@..@..
@@...@.@.@@.@@..@.@.
@@.@..@.@@.@...@....
..@@@...@....@.@.@@.
.@.@.@@..@@@@...@...
........@@@@..@...@@
.@.@.@.@@@@@@..@@...
..@...@@@@@@..@@@.@.
8
17 9 0
13 1 0
7 7 0
14 14 0
10 3 0
18 4 0
11 13 0
2 7 0

13 16 0
16 12 0
12 19 0
14 1 0
2 7 0
13 18 0
13 8 0
8 16 0
