width 20
height 20
@@...........@@@@@@@
@.@.@.@.@.@.@@@@@@@.
@..@...@.@..@@@@@@..
..@.@.@....@@@@@@.@.
@...@.@@@.@@@@@@....
@.@.....@@.@@@@@@.@@
...@.@.@....@@@.....
@.@.@.@@.@@...@.@.@.
..........@.@...@@..
@.@@.@.@.@@@..@..@@.
@..@@@@@.@@@@.@.@...
@.@..@.....@@@...@@.
....@.@.@.@@@@@.@...
@.@@.....@@@@@@.@.@.
...@@@@.@@@@@@@@@..@
@.@@@@@@@@@@@@@@@@..
@@@@@@@@@@@@@@@@@..@
@@@@@@@@@@@@@@@@@@@@
@@@@@@@@@@@@@@@@@@@@
@@@@@@@@@@@@@@@@@@@@
8
1 10 0
7 8 0
17 12 0
1 4 0
2 12 0
12 9 0
9 12 0
9 0 0

19 11 0
11 0 0
8 8 0
10 11 0
11 1 0
6 5 0
5 4 0
19 6 0
