width 20
height 20
.@...@.@@@..@@@@@@@.
...@@...@.@..@@@@...
.@...@.@....@.@@.@.@
@.@@....@.@.........
@....@.@@.@.@@.@@.@.
..@.@......@...@@@..
@..@@@@@.@.@@@..@.@.
@.@.@.@.@.@.@@.@....
..........@..@..@.@.
@.@.@.@.@.@@...@@@.@
...@@@@@@@...@..@@.@
@.@@@.@.@.@@..@@....
..@@.......@@.@..@@.
.@..@.@.@.@....@@...
.@.@.@...@.@@.@@@@.@
...@.@@@.@..@..@@...
.@.........@@@.@.@.@
.@.@.@.@.@@@@.......
..@..@.@..@@@@.@.@.@
.@@@..@@.@@@@@..@...
8
13 3 0
6 4 0
18 11 0
18 1 0
18 3 0
18 16 0
14 16 0
1 3 0

2 0 0
16 11 0
13 9 0
13 14 0
16 3 0
14 17 0
13 15 0
4 18 0
