width 20
height 20
@@@@@@@@@@@@@@...@@.
@@@@@@@@@@@@@@.@....
.@@@@@@@@@@@@.@..@@.
..@@@@@@@@@@@..@@.@.
.@.@.@@@@.@@..@@....
.....@@@...@@.@.@.@@
@@@.@.@.@.@.....@..@
@@@........@@@@...@@
@@@.@@@.@.@..@..@..@
@@@..@.@@@.@...@..@@
@@@@.........@.@@@@@
@.@.@@.@.@@@.@@@@.@@
........@.@....@...@
@.@.@@.@...@.@@.@.@.
..@@..@@@.@@........
@...@..@@....@.@.@.@
..@.@.@@@@.@@...@...
.@.....@@@...@.@@@.@
..@.@.@@@@@.@@.@@@@@
.@@@..@@@@@..@.@@@@@
8
5 10 0
10 16 0
3 11 0
0 17 0
5 12 0
15 2 0
2 17 0
19 1 0

3 18 0
6 12 0
9 8 0
16 2 0
2 15 0
18 4 0
0 4 0
19 0 0
