width 20
height 20
.@...@..@.@@@@.@@...
..@.@.@.@..@@@.@@@.@
.@........@.@...@..@
..@.@.@.@.....@...@.
@....@.@@.@.@..@.@@.
@.@.@@..@..@@@@@@.@.
.@.....@..@.@@.@..@.
..@.@.@@@........@..
@..@...@@@.@.@.@...@
..@@@.@.@.@@@@.@.@..
.@@@@.........@@@@@@
..@.@@.@.@@.@@@@@@@@
@......@...@@@@@@@@@
@.@.@@.@.@@@@@@@@@@@
...@@@@@.@.@@@@@@@@@
@.@@@@@....@@@@@@@@@
@@@@@@@@.@@@@@@@@@@@
@@@@@@@@@@@@@@@@@@@@
@@@@@@@@@@@@@@@@@@@@
@@@@@@@@@@@@@@@@@@@@
8
6 12 0
18 7 0
13 3 0
3 3 0
10 8 0
10 10 0
2 12 0
1 8 0

13 3 0
3 4 0
1 12 0
0 6 0
9 5 0
0 3 0
1 5 0
9 7 0
