width 20
height 20
@@...........@@..@@.
@..@@@.@.@.@@.@@.@@.
@@.@@@@...@.........
@@@.@@.@.@@@.@@.@@.@
@.@.......@....@@@.@
....@@.@.@@@.@.@@@..
@@.@..@...@.@@..@.@.
@....@@@.@@....@....
.@.@..@@@@@.@.@.@.@.
.@@..@.@.@...@@...@@
.@@@......@.@@@.@.@@
..@.@@@.@...@@@..@@@
.@..@@.@.@@@.@@.@@@@
..@..@....@..@...@@@
.@.@.@@@@...@.@.@.@.
..........@.........
@.@.@.@.@..@.@.@.@@@
...@...@.@@.@.@.....
@.@..@@.......@@.@@.
..@@..@@.@@.@....@@@
8
6 1 0
12 9 0
6 13 0
13 14 0
4 8 0
7 2 0
1 1 0
8 1 0

10 9 0
0 15 0
8 13 0
8 5 0
6 10 0
8 9 0
4 4 0
15 13 0
