width 20
height 20
@@@@@@@@@@@..@@.....
@@@.@@@.@@..@@@@.@.@
@@@.......@..@@@.@@@
@.@.@.@.@..@..@..@@@
.....@@@..@@.@.@..@@
@.@.@@@.@.@......@..
..@..@......@.@@...@
.@.@@..@@.@..@.@.@..
.....@..@..@...@.@.@
@.@@..@.@.@@@@@@@...
.@.@.@...@@@@.@@@@.@
.@....@.@@@@@..@@...
...@.@@@@@.@..@@@@.@
.@..@@@..@..@..@@@..
..@..@@@...@@.@.@.@.
@.@.@@@@.@..........
@..@@@@..@@.@.@.@.@.
@@@@@@@@@@@@@@@..@@.
@@@@@@@@@@@@@@..@@..
@@@@@@@@@@@@@@@..@@.
8
4 9 0
12 8 0
12 7 0
15 0 0
11 1 0
7 2 0
11 6 0
2 7 0

0 10 0
10 13 0
7 6 0
1 12 0
3 11 0
19 0 0
2 10 0
8 2 0
