width 20
height 20
....@@@.............
@@.@.@.@.@@@.@.@.@@.
@@.......@@@.@@@.@..
@.@.@.@.@.@.@.@.@.@.
.....@@@............
@.@@.@.@@.@@.@.@.@.@
....@@.....@..@...@@
@.@.@..@.@@.@@..@..@
..@@.@.@.@@....@@@@@
.@.@....@@..@.@.@.@.
@@...@.@@@@@.@@.....
...@.@.@@@@.....@.@.
@.@.@.@.@@.@.@.@@@..
..............@.@.@.
.@.@.@.@.@.@.@@...@.
.@@.@..@@...@...@...
....@@@..@@@@@.@..@.
.@.@.@..@.@.@@@@@@..
@.....@.@....@@@@@@.
..@.@.....@.@@@@@@@@
8
11 19 0
1 19 0
14 8 0
19 17 0
0 11 0
18 10 0
19 3 0
0 16 0

0 13 0
16 0 0
18 12 0
19 17 0
12 14 0
10 13 0
18 4 0
19 13 0
