width 20
height 20
....@..@..@....@..@@
@.@@.@.@.@.@.@@@@..@
...@...........@..@.
@.@..@.@.@.@.@@.@...
....@.@.@.@.......@.
@.@.......@@.@.@@..@
@@..@.@.@@...@@...@.
@..@@@@@@@@@@...@...
@.@@@@@..@.@.@.@@.@.
@@.@@@@.@@...@@@.@..
.@.@@@@....@......@.
.....@@@.@@..@@.@...
.@@.@.@@@.@@...@..@.
...@@.@@.....@.@@@..
@.@@..@.@.@.@...@@@@
...@@.....@@.@.@@@@@
@.@.@.@.@.....@@@@@@
.......@..@@.@@@@@@@
@.@.@.@..@@...@@@@@@
...@..@.@@@@.@@@@@@@
9
2 17 0
19 7 0
2 0 0
0 15 0
17 12 0
3 12 0
3 3 0
12 17 0
12 1 0

17 5 0
16 2 0
0 13 0
4 17 0
7 18 0
8 2 0
17 11 0
15 7 0
17 1 0
