width 20
height 20
@@@@@@@@.......@@@@@
@@@@@@@..@.@.@.@@@@@
..@@@@@@..@@@@@.@.@.
.@.@.@@@.@@@@@......
......@@..@.@..@@.@@
.@.@@@...@....@@....
@@....@.@..@.@@.@.@@
@..@.@@...@@@...@..@
@@.@.@@.@@.@.@.@.@.@
@@@.....@...........
@@..@.@.@@.@.@.@.@@.
@@@.@@.@....@...@...
@@......@@.@@@.@.@@@
@.@.@.@@...@@@...@@@
...@....@.@.@@.@.@@@
@.@.@.@@....@.@.@.@@
........@.@.........
@@.@.@@..@@@@.@@@@.@
@@@@.@..@@@@..@.....
@@@@@@@..@@@@..@.@.@
9
14 7 0
2 10 0
2 8 0
3 4 0
7 12 0
9 2 0
14 10 0
15 11 0
14 8 0

15 9 0
13 18 0
16 16 0
18 8 0
8 1 0
17 3 0
8 19 0
12 1 0
13 0 0
