width 20
height 20
@@@@@@.......@.@..@@
@@@@@@.@.@.@.@...@.@
@@@@@@..@.@....@....
@@@@@@@@..@@@.@.@@.@
@@@@@@@.@...@@@.....
@@@@@...@@.@.@..@.@@
@@.@..@.@.....@..@.@
@@.@@@..@@.@@..@....
.@.@.@@...@.@.@@.@.@
.....@..@@........@@
.@.@@.@.@@.@.@.@.@.@
@@..@.@..@.@.@.@....
@..@....@.@@@.@.@.@@
.@..@.@.............
.@.@.@..@.@.@@.@.@.@
.@....@..@@...@..@..
.@.@.@@.@..@.@@.@..@
..@......@..@....@@@
@.@@.@.@...@.@@.@@@@
......@..@....@@@@@@
9
14 9 0
4 9 0
17 11 0
8 3 0
18 15 0
14 0 0
15 16 0
13 7 0
12 18 0

14 14 0
11 2 0
3 17 0
14 0 0
15 16 0
10 18 0
16 13 0
16 2 0
10 0 0
