width 20
height 20
@.@.@..@@@..@..@..@@
......@.@..@.@...@..
@.@.@....@.....@.@.@
...@@@.@...@.@@@....
@.@@..@@.@@..@..@.@.
.....@@...@@.@@.@@..
@.@.@..@.@.@.@..@@.@
@@..@@.@....@.@.@.@.
...@@....@.@........
@.@...@.@....@.@.@.@
...@@..@.@.@@@@@..@@
@.@...@@....@@@.@..@
@@@@.@@..@.@.@..@@..
@@@@@...@.@....@..@.
@@@@@@@.@...@@...@@@
@@@@@@....@@@@.@....
@@@@@@@@@.@@@.@@@.@.
@@@@@@@@@@@@.....@..
@@@@@@@@@@@@@.@.@.@.
@@@@@@@@@@@@@@......
9
11 13 0
12 1 0
3 6 0
13 17 0
6 6 0
10 1 0
18 12 0
19 18 0
5 11 0

13 18 0
13 17 0
19 12 0
1 2 0
2 3 0
18 15 0
18 5 0
5 13 0
8 7 0
