width 20
height 20
...@.@.@.@.@...@.@.@
@.@..........@@..@..
....@.@.@@.@@.@.@.@.
@.@.@@.@@.@@........
@@........@.@@@.@.@.
@..@.@@.@.....@..@@.
@@..@@@@@@.@.@.@.@.@
.@@@.@@.@.@.........
..@.........@.@.@.@.
.@@@@.@.@@.@...@@@..
..@..@@@..@..@@.@.@.
.@.@.@.@.@.@@.......
............@@.@.@@.
.@.@.@.@.@.@@@.@@@@.
.@..@.@.@.@@@..@.@.@
..@@.......@@@......
.@@.@.@.@@..@..@.@.@
.......@@@.@.@.@@...
@.@.@.@@@........@@.
...@...@@@.@.@.@.@..
9
11 7 0
4 5 0
13 14 0
1 2 0
14 15 0
6 17 0
5 2 0
16 11 0
16 3 0

18 7 0
19 10 0
5 8 0
14 14 0
9 10 0
10 1 0
7 14 0
0 9 0
7 4 0
