width 20
height 20
@@..@@.....@@@.@@@@.
@..@@.@@.@@@@@..@.@.
.@.@@......@.@.@..@.
....@.@@.@.......@..
.@.@@.@...@@.@.@@.@.
..@...@.@..@.@@@....
.@.@.@.@.@@.@.@.@.@.
.......@.........@..
.@.@.@.@.@@@.@.@..@.
.@@@@@.@@.@@@.@@@...
...@.@.....@@...@.@@
@.@@...@@@.@@.@...@@
.@@@.@@.@.@.@@..@...
............@.@..@.@
.@.@.@.@@.@.....@@@@
@...@.@..@@@.@.@@@.@
@.@.....@@@...@.@@.@
...@.@.@@@@@@...@...
@.@@@...@@@@@@.@.@.@
...@@@.@@@@@@.......
9
16 11 0
7 16 0
6 13 0
16 19 0
19 4 0
0 19 0
1 7 0
2 6 0
6 16 0

1 19 0
2 0 0
7 13 0
9 13 0
14 19 0
19 1 0
19 0 0
16 7 0
17 12 0
