width 20
height 20
.@@...@@@@@@@@.@.@..
...@.@.@@@@@@......@
.@@.....@@@@.@.@.@.@
....@.@.@.@.....@.@.
@.@.@@....@.@.@.....
@@@@@@@.@..@.@@.@.@@
@@@@@...@@.@...@..@@
@..@@@@.@.@.@.@.@.@@
@@.@@...@.........@@
@@...@.@@.@.@@.@.@.@
@@.@@......@.@@@@@.@
@.....@@@.@@...@....
..@.@..@.@@.@.@@@@.@
@..@.@.........@.@.@
..@..@.@.@.@.@......
@.@.@.@@@.@..@.@.@.@
......@.@...@..@@...
@.@.@....@@@..@@..@.
...@@@@@....@@...@@@
@.@@@@@@@.@...@@.@@@
9
3 3 0
12 10 0
12 19 0
7 8 0
1 14 0
14 6 0
11 12 0
9 9 0
1 17 0

2 11 0
1 3 0
0 12 0
4 9 0
15 5 0
12 3 0
10 16 0
16 19 0
16 13 0
