width 20
height 20
@..@@@@@@@@@@@@@@@@@
..@..@@@@@@@@@@@@@@.
@...@@.@@@@@@@....@.
..@.....@@@.@..@@@..
.@..@@.@@@...@..@.@.
@.@.@@@.@.@.@.@.@...
@....@...........@@.
..@.@.@.@.@.@.@.@...
@.@.@..@.@...@@@@@@.
..@@@@.@.@@.@.@@@@..
@...........@..@@.@.
@@.@@.@.@@@...@@....
@..@@@..@@.@.@..@@@.
@@.@@@@.@..@@@@.....
@@@@@@....@@@@..@@.@
@@@@@@@.@@@@...@@@..
@@@@@@@.@..@@@..@..@
@@@@@@....@..@.@.@..
@@@@@@@.@...@..@...@
@@@@@@@@..@...@..@..
9
16 13 0
5 7 0
18 18 0
19 17 0
12 11 0
14 16 0
15 19 0
12 12 0
2 12 0

11 8 0
13 15 0
15 13 0
10 16 0
18 7 0
1 3 0
11 18 0
3 8 0
6 17 0
