width 20
height 20
.@.@@@..@@@.@.@.@@@.
....@.@..@.......@@.
@.@.....@.@.@.@.@@@.
.@.@@@@......@...@..
...@.@..@@@.@@@.@.@.
.@....@.@@@@........
.@@.@....@@@.@.@.@.@
..@.@.@@..@.@.@.@.@.
.@.@@.@..@@.......@.
...@.@.@@@..@.@@@...
.@.....@.@@..@@.@@@.
..@.@@......@@......
.@.@@.@.@.@.@.@.@@@.
.......@@@.@@.@..@..
.@.@.@@@@...@..@..@.
@...@.@@.@@..@..@@..
.@.@........@.@.@.@.
.....@@.@.@@@...@.@.
.@.@@@@@....@.@.....
.@@@@@@@@.@..@@.@.@.
9
16 18 0
14 14 0
2 4 0
15 15 0
17 7 0
13 1 0
9 16 0
0 12 0
15 16 0

11 15 0
19 19 0
13 14 0
15 4 0
15 15 0
8 16 0
2 0 0
15 3 0
14 17 0
