width 20
height 20
@@@@.@.@.@.@@.@.....
@.@...........@.@@.@
...@@.@.@@@.@@.@.@.@
.@@.@@...@..........
.@....@.@.@.@.@@.@.@
..@.@.@....@@...@..@
@....@@.@.@..@.@@@..
..@.@@@..@@.@@.@...@
.@.@..@.@.@.@..@@@@.
.....@.......@.@....
.@.@@@.@.@@.@.@.@.@.
@...@..@@.......@..@
@@.@..@@.@.@@.@...@@
@....@@@..@@@.@@@.@@
@@@@..@.@...@@.....@
@.@.@....@@...@.@.@.
......@.@@.@.@@@....
@.@.@.@......@@.@@.@
...@..@.@.@.@.......
@.@@.@...@...@.@.@.@
9
10 12 0
6 10 0
19 8 0
14 11 0
11 4 0
6 3 0
13 5 0
15 10 0
11 6 0

13 5 0
17 0 0
8 7 0
3 7 0
5 11 0
8 9 0
6 10 0
7 3 0
10 19 0
