width 20
height 20
..@.@.@.@.@@......@@
.@.........@.@.@@.@@
...@.@.@@@@@@....@..
.@..@@@@@@@@@@.@.@.@
@..@@..@@@@@@...@...
..@.@.@@.@@@.@.@.@.@
@...................
@@.@.@@@@@.@@.@.@.@.
@@.@@........@...@..
...@..@.@.@.@.@.@@@.
@.@@@..@@@.....@@@@@
@.@@@.@@@.@.@.@@@@@@
.@@@..@.....@@@@@@@@
.@@@@..@@.@..@@@@@@@
.@@@.@.@...@@@@@@@@@
..@...@@@.@@@@@@@@@@
.@..@..@....@@@@@@@@
.@.@.@@@@@@..@@@@@@@
.....@.@....@@@@@@@@
.@.@.....@@.@@@@@@@@
9
15 6 0
10 6 0
10 8 0
5 8 0
18 2 0
17 6 0
6 2 0
14 2 0
1 9 0

7 1 0
5 9 0
0 13 0
3 15 0
4 18 0
4 15 0
10 16 0
0 18 0
1 6 0
