width 20
height 20
@@...@@@@@@@@@@@@@@@
@..@..@@@@@@@@@@@@@@
@@..@..@@@@@@@@@@@@@
...@@.@.@.@@@@@@@@@@
@@..@......@@@@@@@@@
@@@@.@.@.@..@@@@@@@@
@@....@@@..@@@@@@@@@
@..@@@@@.@.@@@@@@@@@
@.@@.........@.@@@@@
....@.@.@@.@@....@@@
@.@....@@@@@@@.@..@@
..@@@.@.@@@@@.@..@.@
@....@@..@@@..@@....
..@.@@@.@.@.@.@@.@.@
.@....@.........@...
..@.@.@@.@.@.@@@.@.@
@@@..@@@@@@...@.....
@...@.@@.@.@.@.@.@.@
.@@...............@@
....@.@@.@@.@@.@.@@@
9
2 4 0
7 12 0
2 14 0
12 18 0
13 16 0
0 15 0
11 19 0
18 15 0
13 18 0

0 19 0
15 11 0
4 8 0
0 11 0
7 3 0
0 9 0
7 11 0
2 1 0
8 8 0
