width 20
height 20
...@..@..@.@@..@.@..
.@.@.@..@.....@..@.@
@@.....@@@@.@.@@....
..@@.@.@...@.....@.@
.@@@@@...@..@.@@@.@@
...@...@..@@........
.@.@@.@.@@.@@@.@.@.@
.@@.@.......@@@@@...
.@@.@@.@.@.@.@.@.@.@
.@@.@@@.@@..........
.....@@.@..@@.@@.@.@
@@@@.@..@@..@.@@@...
......@..@.@@@@@@@.@
.@.@.@.@...@@@@@@@@@
..@@....@.@.@.@.@@.@
.@@@@@@.............
@.@.@...@@.@@.@.@.@.
......@@....@@...@..
.@.@@..@.@.@@@@.@@@.
@@@...@@@@@@@@@@....
9
18 3 0
10 3 0
14 6 0
18 5 0
5 17 0
13 15 0
19 16 0
2 13 0
13 1 0

9 10 0
8 4 0
9 13 0
0 8 0
7 12 0
19 5 0
7 4 0
10 6 0
3 19 0
