width 20
height 20
@@@@@@@@@..@@@...@@@
@@@@@@@@..@@..@.@.@@
@@@@@.@.@....@......
@@@@......@.@.@.@.@.
@@@.@@@.@@@@....@..@
@.@.......@@@.@@.@@.
....@.@.@@.@......@.
@.@..@@......@.@.@@.
@@..@.@.@.@.@.@...@.
@@@...@@.@.@..@.@@..
@@.@@........@.@.@.@
@...@@@.@@.@........
..@....@.@@@@@.@.@.@
@.@.@.@@...@...@@...
.@..@.@..@@.@.@...@.
..@..@@@......@@.@..
@...@.@.@@.@@.@@..@.
@@.@.........@...@..
@...@.@.@.@.@@@.@@@.
@@@....@...@@@@@@@@@
9
1 15 0
14 13 0
8 15 0
9 1 0
12 9 0
3 8 0
5 19 0
13 5 0
16 2 0

18 10 0
16 7 0
4 12 0
2 10 0
18 15 0
1 5 0
5 9 0
6 10 0
3 6 0
