width 20
height 20
@.@.@.@@.@.@@.......
...........@..@.@.@.
@.@.@.@.@@.@@.@..@..
@..@@@@@@...@.@@@@@.
.@@@@@@@.@.@.....@..
..@@@@@......@.@@@@.
.@.@@@.@@.@@.@@..@..
..........@...@@..@.
.@.@.@.@.@..@.@.@..@
..@@..@@@@@.@.....@.
.@@@.@.@.@...@.@.@..
.@@.@.....@.@.@..@.@
.@@.@.@.@......@@...
@.....@@..@.@.@@.@.@
..@@.@...@.@..@..@..
@..@@@@.@....@@.@@.@
..@..@.@.@@.@.......
@.@@......@.@@.@@.@.
.....@@@.@.@.@...@@.
.@.@..@........@@...
9
19 1 0
6 16 0
12 14 0
7 12 0
1 5 0
13 12 0
4 8 0
1 17 0
5 7 0

10 3 0
10 18 0
7 19 0
2 15 0
19 16 0
17 16 0
14 16 0
16 13 0
11 8 0
