width 20
height 20
@@@@@@@@@@@@@@@@@@@@
@@@@@@@@@@@@@@@@@@@@
@@@@@@@@@@@@@@@@@@@@
@@@@@@@@@@@@@@@@@@@@
@@@@@@@@@@@@@@@@@@.@
@@@@@@@@@@@@@@@.@...
@@@@@@@.@@@@@@....@@
@@@@@@..@@@.@.@.@@.@
@@@@..@.@...........
@@@.@....@@@.@.@.@.@
.@....@@...@@.@.@..@
.@.@@..@.@....@...@@
..@...@@@..@.@@.@.@@
.@@@.@.@.@@.@.@..@@@
..............@.@@@@
.@.@@.@@.@@.@....@@@
@....@@.@@@@.@.@@@@@
.@@.@......@.@.@@@@@
......@.@@....@@@@@@
@.@.@..@@@.@.@@@@@@@
9
19 5 0
5 8 0
10 12 0
3 17 0
4 14 0
14 6 0
9 12 0
4 8 0
8 14 0

15 8 0
7 9 0
4 14 0
16 13 0
6 9 0
12 16 0
7 6 0
10 18 0
6 7 0
