width 20
height 20
@.@.@@@@@.@.@@...@@.
.....@.@@....@@@.@..
.@@.@.....@.@@....@.
@@....@.@.@@@.@@@.@.
@@@.@@@.@...........
@.@@....@.@.@.@.@.@.
....@.@..@.@@@.@@..@
@.@@...@@@.@...@@.@@
....@@.......@...@@@
.@.@.@.@.@@.@@@.@@@@
@.....@..@...@@@@@@@
.@.@@.@@..@.@@@@@@@@
.....@@@.@.@@@@@@@@@
@.@.@.@....@@@@@@@@@
..@....@@.@@@@@@@@@@
@@@@@@..@.@@.@@.@@@@
@@@.@.@...@@.....@@@
@@......@....@.@@@@@
@@@@.@.@..@.@@@@@@@@
@.....@..@...@@@@@@@
2
4 7 0
16 4 0

14 0 0
3 8 0
