width 20
height 20
@....@@@@..@@.@.@@..
..@.@.@.@@.........@
@..@..@.@.@@.@.@.@..
..@.@........@..@..@
@.@...@@.@.@@.@@.@..
....@.@.@@@.@......@
@.@.@@..@@..@.@.@@..
..@@..@...@.@..@@.@.
@...@.@.@.@...@@@...
..@......@@@.@.@.@@.
.@..@.@.@@@.......@.
.@@..@@@@@@@.@.@.@.@
@@@@.@@.@@@@@@@....@
@@@@@@...@.@.@@@.@..
@@@@..@.@@......@@@.
@@@@@......@@.@@@@..
@@@@@@.@.@.@..@.@.@.
@@@@@@@..@@@@.......
@@@@@...@@@@@.@.@.@.
@@@@@@.@@@@@@@@@..@.
2
16 1 0
14 2 0

18 11 0
16 5 0
