width 20
height 20
@..@@@@@.....@@@.@.@
@.@@@@..@.@.@@@.....
...@@.@.@@..@@.@.@@@
@.@@......@.........
.....@@.@.@.@.@@.@@.
@.@.@....@@@@@.@@.@.
...@.@.@@@..@.......
.@.@....@..@.@.@.@@.
..@@@.@@.@...@..@@..
.@@@.......@...@@.@.
@.@.@@.@.@.@.@.@..@.
@.......@@@@.@@..@.@
@.@.@@.@@@.@@.@@....
@.@@@.@.@@......@@.@
@..........@.@.@.@.@
@@.@.@.@.@..@.......
@@.@@...@..@@@@.@.@@
@@@@.@.@@@@.@.@@@...
.@........@.......@.
...@@@.@@..@.@.@.@..
2
11 17 0
5 5 0

8 0 0
5 2 0
