width 20
height 20
..@@@.@@.@@@....@@..
@..@@.....@.@.@.@@.@
@.@@@.@.@.....@.@...
...@@..@@@.@.@..@@.@
@.@.@.@.@.@@@.@.....
...........@@.@.@.@.
@.@.@.@.@@....@@.@@.
...@..@.@@@@@..@....
@.@@.@@@.@.@@.@.@.@.
.@@.@.@..........@@@
......@.@@.@@.@.@@@@
.@.@@....@.@@@...@@@
..@@@.@.@.@.@@@.@.@@
.@.@.@.@.....@.@...@
.........@.@.@.@@.@.
.@.@.@@.@..@........
..@@@.@..@..@.@.@.@.
.@@.@.@.@..@.@.@@@..
......@.@@.@.@.@@@@.
.@.@@@@@@@.......@..
2
9 2 0
11 19 0

12 9 0
11 2 0
