width 20
height 20
@@.@.....@.@.@@@@@@@
@...@@.@.......@@@@@
..@.@@@..@.@.@..@@@@
@.@....@..@@.@.@@@@@
.@.@.@@.@...@.@@.@.@
..........@.@.......
@.@.@@.@.@..@.@.@.@.
...@@@@@@@@.@@.@@@..
@.@.@@.@.@.@.@.@...@
.................@.@
.@.@.@.@.@.@.@.@..@@
..@.@@..@@@.@.@@@@@@
.@@.@.@.@@@....@.@@@
.......@.@.@.@.@.@@@
.@.@.@......@..@..@@
@@.@@..@@.@..@..@..@
...@@@...@..@.@...@.
.@.@@..@@.@...@.@...
..@@@@.@....@....@.@
.@@@@@@@@.@.@.@.@...
2
5 13 0
5 5 0

6 14 0
6 8 0
