width 20
height 20
@.....@@@.@......@.@
.@@@.@.@@...@.@.@...
.@.......@.@.@...@.@
..@@.@.@..@....@....
@.@.@.@.@.@@.@@..@@.
....@.........@.@.@.
.@@@..@@.@@.@.@@....
...@@.@@..@@.@...@.@
.@.....@.@.....@..@@
@..@@@..@@.@@@..@.@@
..@@@.@...@....@....
@...@...@..@@.@.@.@@
..@.@.@@..@@@....@@@
@..@@@@..@.@@@.@.@.@
..@.@.@.@...@.@.....
@.....@...@@..@.@@@@
@@@.@..@.@..@.@@.@.@
@@@@..@.@.@.@..@....
@@@.@.....@...@@.@.@
......@.@...@.....@@
2
11 19 0
0 3 0

5 5 0
13 12 0
