width 20
height 20
@.....@..@@@@@@.@@@@
@.@.@@..@..@@@@.@@@@
..@.@.@.@.@.@@....@@
@.@@...........@.@@@
...@.@.@.@.@.@.@.@@@
@.@..@@@..@@@...@@@@
....@....@@@.@.@.@@@
@.@.@.@.@@@.......@@
@@@@.@.@.@.@.@.@.@.@
@@.@..........@..@.@
@@...@.@@.@.@..@....
...@@@@.@@@@..@..@.@
.@..@@......@..@@...
@..@@@.@@.@@.@@@.@@.
.@.@@....@@.........
....@.@.@@@.@.@.@.@.
.@.@...@@@@..@.@...@
..@@@.@.@@..@@.@@.@.
.@.@.......@@@..@.@.
...@@.@@.@.....@....
2
5 18 0
17 12 0

16 7 0
0 6 0
