width 20
height 20
@@....@..@..@......@
@@.@.@.@.@.@..@.@.@.
@@.@.@.@...@@..@@...
@@@......@..@.@@..@.
@@@@.@.@.@.@....@..@
@@@...@.@.@.@.@..@..
@..@@..........@.@.@
@@....@.@.@.@.@.@@@@
@.@.@.@.@@@@.....@@@
.....@@@@@@@@.@@@@@@
.@.@..@@@@@@@@@@@@@@
..@@@@@@@@@@@@@@@@@@
@@@@@@@@@@@@@@@@@@@@
@@@@@@@@@@@@@@@@@@@@
@@@@@@@@@@@@@@@@@@@@
@@@@@@@@@@@@@@@@@@@@
@@@@@@@@@@@@@@@@@@@@
@@@@@@@@@@@@@@@@@@@@
@@@@@@@@@@@@@@@@@@@@
@@@@@@@@@@@@@@@@@@@@
2
0 10 0
9 7 0

12 6 0
13 5 0
