width 20
height 20
....@.@.@@@@@.@...@.
.@@......@@@@..@@...
@@@@.@@.@@@@@@.@.@@.
@@@@@@....@@@.......
@@@@..@.@@@@@@@@@.@.
.@@..@...@@@@@@@@@@.
..@@...@@.@@@@@@@...
.@@@.@....@@.@.@.@@.
..@.@.@@@...........
@.........@.@@.@.@@.
..@@@.@.@.@.@@@@.@@.
@...@..@.@.@.@.@@.@@
@.@@.@.@.@.........@
.....@@@.@.@.@@.@.@@
.@.@........@@@@.@@@
..@.@.@@.@.@@@@@.@@@
@...@@@.@.@.@@@...@@
.@.@@.@......@.@@.@@
........@@.@.......@
.@.@.@.@@@@..@.@@.@@
2
1 0 0
5 0 0

11 14 0
0 17 0
