width 20
height 20
.....@...@@.@@@.@..@
.@.@..@@..@..@....@@
..@@.@.@.@..@@@.@.@@
.@........@....@...@
..@.@.@.@...@@@.@.@.
.@@@.@..@.@@@@......
.....@.@....@.@.@.@@
@@@@@.@.@.@@@....@@@
@.............@@.@@@
@@.@@.@.@.@.@@@.....
.....@@@.@.@.@.@.@.@
@.@.@@@@.@.......@@@
...@@@@....@.@.@..@.
@.@@@@@@.@..@...@...
..@@@@@@..@.@.@@@.@.
@..@@@@.@..@.@...@..
..@.@@...@@....@.@@.
@......@@@.@@.@.....
..@.@@.@.......@.@@.
.@@.@@@..@@.@.@@..@.
2
17 6 0
18 9 0

0 16 0
3 10 0
