width 20
height 20
@@.@.@@@.@@.@@@@@@@@
......@...@.@..@@@@@
@.@@.@..@....@..@@@@
@.@.@.@..@.@...@@@@@
@......@@@@@.@@@@@@@
@@.@@.@@@@...@@@@@@@
@@@...@@@..@.@@@@@@@
@@.@.@.@.@@@.@@@@@@@
@@.......@....@@@@@@
@@@.@@.@.@.@.@@@@@@@
@@@.@..@@.@...@@@@@@
@@@@.@..@...@@@@@@@@
@@@@.@@...@@@@@@@@@@
@@@.....@...@@@@@@@@
@@@@.@.@..@.@@@@@@@@
@@@@@..@@@@@@@@@@@@@
@@@@@@.@@@@@@@@@@@@@
@@@@@@@@@@@@@@@@@@@@
@@@@@@@@@@@@@@@@@@@@
@@@@@@@@@@@@@@@@@@@@
2
3 6 0
12 7 0

10 2 0
1 2 0
