width 20
height 20
...@.@.@.@@.@@@.@@@@
.@.......@..@@...@@@
.@.@@.@@.@@.@.@.@.@@
@....@@............@
@@.@@@@@.@.@.@.@.@..
@@@@@@@@@..@@...@..@
@@@@@@@@@@@@.@.@..@@
@@@@@@@@@@@.....@@@.
@@@@@@@@@@@@.@.@....
@@@@@@@@@@@@@@...@.@
@@@@@@@@@@@@...@..@@
@@@@@@@@@@@@.@.@@...
@@@@@@@@@@...@...@@@
@@@@@@@@@@.@.@@.@@@@
@@@@@@@@@@..@@@...@@
@@@@@@@@@@.@@@@.@..@
@@@@@@@@@@..@@@@..@.
@@@@@@@@@@@.@@@@@...
@@@@@@@@@@..@.@.@.@.
@@@@@@@@@@@......@..
2
17 17 0
16 12 0

11 1 0
19 4 0
