width 20
height 20
@@.@@@@.@...@@@.@.@.
@....@..@@@..@....@.
.@.@@.@..@.@.@@.@@..
....@..@.....@..@@.@
.@.@@.@..@@@@@@.....
..@.....@@.@.@.@@@.@
@.@@@.@.........@@..
@..@@..@@.@.@.@..@.@
..@@.@@.@@.@.@.@.@.@
@..@................
.@..@.@@.@@.@.@.@@.@
.@.@..@..@@@...@...@
.@.@.@.@@@@@@.@@@@..
.......@@@@@..@.@.@.
.@.@.@@@@@@@@.....@.
.@.@.@@@@@@@@.@@@..@
..@@@@@@@@@@.@@...@@
.@@@@@@@@@@.....@.@@
@@@@@@@@@@.@@@@.@..@
@@@@@@@@@.......@@.@
2
15 10 0
18 15 0

19 6 0
0 11 0
