width 20
height 20
@@.@@@@@@@@@@@@@@@@@
@...@@@@@@@@@@@@@@@@
.@.@@@@@@@@@@@@@@@@@
....@@@@@@@@@@@@@@@@
.@@..@@@@@@@@@@@@@@@
@@@.@.@..@@@@@@@@@@@
@@....@.@.@@@@@@@@@@
@@@.@.@...@@@@@@@@@@
@@@@....@.@@@@@@@@@@
.@@.@.@..@.@.@@@@@@@
..@..@..@@....@@@@@@
.@@@.@.@.@.@.@@@@@@@
..@.........@@@@@@@@
.@@@.@.@.@.@@@@@@@@@
..@...@@..@@@@@@@@@@
.@.@@..@.@@@@@@@@@@@
......@.@.@@@@@@@@@@
@@.@@......@@@.@@@@@
.....@@.@@......@@@@
.@.@...@...@.@@..@@@
2
6 15 0
6 11 0

0 4 0
5 5 0
