width 20
height 20
@@@.@..@@@@@@@@@.@@.
@@@..@.@@@@.@@@...@.
@@.@....@@@..@@@@...
@..@.@.@@@..@@@@@@@.
.@.@..@@@@@..@@@@...
.....@.@@.@.@@.@.@@.
.@@.@@..............
.@.@.@@.@.@.@.@@@.@.
.........@@..@@@...@
.@@.@.@.@@..@@@@@.@.
...@@@..@.@.@.......
.@.@@.@.@...@.@.@.@.
.@@@...@@.@.@@@.@@..
@.@@@.@@@..@.@.@@@@.
@..@...@..@.....@...
..@.@.@.@...@@.@..@.
@.........@.@...@..@
..@.@.@.@..@@@.@..@.
@.@..@...@...@@.@...
@@..@..@..@@..@...@.
2
11 18 0
5 12 0

19 17 0
18 4 0
