width 20
height 20
@@@..@@.@.@@.@.@....
@@@@.@...........@@.
@@@....@.@.@@.@@..@@
@@@@.@.@@@@@@@.@.@.@
@.@@@@.@.@.@@.......
@..@@........@.@@@.@
..@..@@.@.@.@@....@.
@...@....@@@.@.@@@..
..@@@.@.@@@@.......@
@.@....@@@@.@.@@.@..
....@.@.@@..@@....@.
@.@.@@..@.@...@@.@..
...@..@.@..@.@.@@.@.
@.@@.@....@.........
@.....@.@.@.@.@@.@.@
@.@.@....@.@.@@.@..@
@@@@..@.@@.@.@..@.@.
@@@@@@.....@.@@.@...
@@@@@@@.@.@.......@.
@@@@@@@@..@@@@.@.@..
7
9 17 0
8 7 0
7 5 0
7 6 1
7 14 1
15 18 2
14 18 2

16 1 0
14 0 0
15 13 0
17 8 1
5 7 1
16 4 2
17 17 2
