width 20
height 20
@@@@.@.@@@.@@.@.@.@.
@@@........@....@.@.
@@@@.@.@@.@@@.@.....
@@@@@...@.@...@.@.@.
@@@@.@.@.@.@.@...@@@
@@..........@.@.@.@.
@@@@.@.@.@@.........
..@...@@@@..@@.@.@.@
.@.@.@.@.@.@...@@...
..........@@.@@.@@@.
@.@.@.@@@.@.@.@.@.@.
@@.@..@@...........@
.....@@@@.@.@.@.@.@.
.@.@.@.....@..@@....
@...@.@.@.@@@.@@@.@.
.@.@...@.@.@.@.@.@..
....@@.....@...@..@.
@.@@...@.@...@..@.@.
...@@.@@@..@..@.....
.@...@@@@@.@.@@.@@.@
7
5 10 0
12 18 0
3 19 0
6 2 1
10 11 1
12 3 2
4 6 2

12 15 0
16 16 0
0 12 0
17 18 1
14 16 1
13 11 2
18 18 2
