width 20
height 20
@@.@...@@...@..@..@@
@@..@@..@.@...@.@..@
@@@....@...@.@....@.
....@@.@@.@.@.@@@...
.@@...@.@......@@.@.
@@@@.@....@@@@.....@
@@@....@.@.@..@.@@..
@@@@.@@......@.@..@.
@@@@@...@@.@....@...
@@@@@@.@@@.@@@.@.@.@
.@..@.@.@.@......@..
...@........@@.@..@.
@@.@@@@.@@.@.@..@.@@
...@.@.@...@..@@...@
@.@@.@...@...@@.@@.@
.......@.@@.@@@.@..@
@.@.@.@@@..@......@@
...@.@.@.@.@.@.@.@@@
.@..........@...@@@@
..@.@.@@.@.@@@.@@@@@
7
6 9 0
5 0 0
11 3 0
0 18 1
2 15 1
1 16 2
12 13 2

1 15 0
7 5 0
11 18 0
17 5 1
7 7 1
12 8 2
19 11 2
