width 20
height 20
@@...@@@@@@@@@@@@@@@
@..@.@@@@@@@@@@@@@@@
.@..@.@.@.@@@@@@@@@@
...@....@.@.@.@@@@@@
.@@.@.@...@.@..@@@@@
.@..@.@.@.....@@@@@.
..@..@.@@.@@@...@@..
@.@.@...@@....@@@.@.
......@@.@.@@.......
@.@@.@@@...@..@@.@.@
..@.@.@..@.@@...@..@
@.@.....@@@.@@.@..@.
....@.@.@.@..@@@@@@.
@.@.@@.@..@.@..@....
...@@@.@@...@.@.@@.@
.@........@.........
@.@.@@.@.@..@.@.@.@.
@..@@@@...@.@@..@@..
.@...@.@.@@.@.@..@@@
...@.......@....@@@@
7
5 2 0
16 9 0
15 6 0
6 18 1
0 5 1
2 2 2
5 3 2

10 5 0
6 19 0
14 6 0
17 7 1
3 7 1
9 6 2
13 9 2
