width 20
height 20
.@@@@@....@@@@@@@@@@
..@@@..@@.@@@@@@@@@@
.@.@.@.@.@..@@@.@@@.
...@.@...@.@.@...@..
.@...@.@......@.@.@.
..@.@.@@@.@@@.@.....
.@@.....@.@.....@@.@
.@@@@.@..@.@.@.@@@.@
..@@@.@.@.....@.@...
.@.@.@.@.@.@.@@.@@@.
.@.........@@.......
.@.@.@.@@.@@@.@.@.@.
..@.@@@@.@@@...@@@@.
@.........@.@.@@@@.@
@@.@@.@.@.....@@@@..
.....@@@@@@.@.@@...@
@@.@....@.@@@@.@.@..
@@@.@.@.........@..@
@@@...@.@.@.@.@@.@.@
@@@@@..@...@........
7
11 13 0
12 17 0
7 3 0
13 18 1
12 12 1
12 4 2
15 17 2

1 15 0
13 4 0
3 4 0
18 16 1
3 12 1
5 13 2
9 1 2
