width 20
height 20
@...@@@@...@..@@....
.@.@..@.@.@@.@@.@@@.
....@.........@..@..
.@.@.@@.@@.@.@@@...@
.@@......@.@@..@@@..
....@@.@@.@.@@...@.@
.@@.@.@.@......@....
..@.......@.@.@.@.@.
@.@.@.@.@..@....@@..
..@..@..@@@@.@@..@.@
@.@.@..@.@@.@.@.@@@.
@@@@..@.............
@.@.@@@@.@.@@.@@.@@.
......@..@.@@@@@@.@.
@.@.@..@.@..@.@@@...
.@@@@@....@@@...@.@.
.......@@.@@..@@...@
.@.@@.@@.@@.@.@.@.@.
@....@..............
@@.@..@.@.@.@.@.@@@@
7
7 4 0
8 17 0
0 6 0
19 12 1
1 5 1
12 3 2
11 18 2

13 10 0
15 19 0
8 7 0
8 17 1
8 11 1
10 6 2
10 2 2
