width 20
height 20
@@.@.@.@@@@.@.@.@@..
@@.......@.........@
@@@.@.@.@.@.@.@.@.@@
@@@.@@.......@...@.@
@@@.@.@.@.@.@@@.@...
@@@...@.@.@.@@@..@@.
@@@@.@@@.@.@.@.@....
@@@@@@@@.........@.@
@@@@@@@@.@.@.@@.@...
@@@@..@...@@.@@.@@@.
@@@@.@.@.@..@.@.@@@.
@@.........@...@.@.@
@@@@.@.@.@...@.@....
@@@@@..@..@@.@@.@@.@
@@@@@@.@.@.@........
@.@.@@..@..@.@.@@.@.
.......@.@....@@@@..
@@.@.@...@.@.@@@@@@.
@@..@..@..@@@@@@@@@@
...@@.@..@@@@@@@@@@@
7
19 5 0
13 14 0
15 5 0
1 16 1
14 14 1
18 16 2
12 12 2

16 3 0
12 14 0
7 5 0
18 8 1
12 9 1
15 13 2
15 5 2
