width 20
height 20
.@......@@.......@@@
...@@.@@@@@.@.@@..@@
.@.@.@@@@@.@@.@..@@@
@.....@@@@.@.@.@..@@
.@.@.@.@@........@@@
....@....@.@.@.@@@@@
.@.@@@.@@.@..@@@@@@@
..@.@.......@.@@@@@@
.@@...@.@.@....@@@@@
....@..@...@@@@@@@@@
@.@..@@.@.@..@@@@@@@
@@@.@@......@@@@@@@@
.....@@.@.@.@@..@.@@
.@.@..@@.@.@.@.@@..@
@.@.@.............@@
......@.@.@.@.@.@@@@
.@.@.@...@...@.....@
@.@.@.@.@.@.@@@.@.@@
...........@@@@@....
@@.@@.@@.@@@@@@@@.@.
7
15 4 0
17 1 0
1 5 0
2 1 1
12 3 1
12 16 2
7 5 2

8 5 0
18 18 0
2 3 0
19 18 1
1 7 1
3 7 2
5 8 2
