width 20
height 20
@.@@.@@.@.@@@@@@@@@@
........@...@@@@@@@@
@.@.@.@...@.@@@@@@@@
..@..@..@@@@@@@@@@@@
@..@@@@.@@@@@@@@@@@@
..@@.@.@@@@@@@@@@@@@
@.......@@@@@@@@@@@@
.@.@@@.@@@@@@@@@@@@@
....@...@@@@@@@@@@@@
.@.@@@.@@@@@@@@@@@@@
..@@@....@@@@@@@@@@@
.@.@.@.@..@@@@@@@@@@
.....@@..@@@@@@@@@@@
.@.@.@@@.@@@@@@@@@@@
.@@@@@@@..@@@@@@@@@@
@@@@@@@..@@@@@@@@@@@
@@@@@@@@.@@@@@@@@@@@
@@@@@@@@@@@@@@@@@@@@
@@@@@@@@@@@@@@@@@@@@
@@@@@@@@@@@@@@@@@@@@
7
11 2 0
4 6 0
8 13 0
4 5 1
2 6 1
2 8 2
4 0 2

2 13 0
7 4 0
11 1 0
4 5 1
8 11 1
11 2 2
2 7 2
