width 20
height 20
@@.@.@@@@....@.@@@.@
@....@@@@@.@@@.@@...
@@@.@.@.@...@@.@.@.@
@@......@.@.........
@..@@@.@@.@@@@@.@@.@
..@....@...@.@.@.@..
@..@@@.@.@.@......@@
..@.@.@.@..@.@@.@.@.
@...@...@@...@.@@.@.
@.@...@.@@.@@...@@..
.@@.@@.@.@.@.@.@@..@
.................@..
.@.@.@.@.@.@@.@.@.@.
..@.@.@@@@@@@@......
@.@.@..@@..@@.@.@@.@
.....@...@......@..@
@.@.@@.@@..@.@@.@@.@
@@.......@..@...@@@@
@@@.@.@.@..@@@.@@@@@
@@@@...@@@..@.....@@
7
1 14 0
3 5 0
18 9 0
2 11 1
10 6 1
11 11 2
1 16 2

6 16 0
10 8 0
17 8 0
18 14 1
8 12 1
18 5 2
2 15 2
