width 20
height 20
...@@@@@@..@@@...@..
@.@.@.@@.@..@.@.@.@.
...........@..@...@.
@.@.@.@@.@@.@.@@@...
..@.@@...@....@@.@@.
@@.@@.@@..@.@.@.....
.@....@.@.@.@@@@.@@.
...@@...@.@.@.@.@.@.
@@.@.@@...@.........
.......@.@..@@.@@.@.
@.@.@.@.@.@@@.@@@@..
...@@...........@@@.
@@...@.@@@.@.@@..@..
...@@.@@@@.@.@.@@.@.
@@....@@@@@.........
@@.@.@@@@@@@.@@.@.@.
@@..@@@@@@@@@@@@...@
@@@..@@@@@@@@@@@@.@@
@@@@@@@@@@@@@@@.....
@@@@@@@@@@@@@@@.@.@.
7
11 14 0
2 13 0
1 4 0
19 11 1
3 1 1
5 14 2
2 12 2

16 4 0
9 7 0
10 0 0
6 4 1
19 14 1
1 13 2
14 0 2
