width 20
height 20
......@.@.@@@@.....@
@.@@@......@@@@.@.@@
..@.@.@@.@@@.@@@...@
@.@..@@...@...@.@@.@
..@.@@.@.@.@.@......
.@...@.@.......@@.@.
@.@@.....@.@.@...@..
.....@.@@@@.@@@.@@@.
.@@.@..@.@..@@@@@@..
@...@@.@.@@..@@.@.@.
@.@...@.....@.......
@.@.@@@.@@.@@@.@.@@.
...@@@@.@@@@@..@@.@@
@.@@@@@.@@@@@@......
@@@@@@@..@@.@..@@.@.
@@@@@@@.@.@.@@..@@..
@@@@@@.........@@@@.
..@@@@.@.@.@.@.@@@..
.@@.@@..@@..@...@@@.
.......@@@.@..@.@@@.
7
16 2 0
1 11 0
17 0 0
12 16 1
13 10 1
5 19 2
19 10 2

11 10 0
19 11 0
15 1 0
19 13 1
12 3 1
3 7 2
3 5 2
