width 20
height 20
@..@@@.@.@.@......@@
.@.@.@.......@.@.@.@
.......@.@.@..@.@@.@
.@.@@@.@..@..@@..@..
.@....@.@..@....@..@
@@@.@.@...@@@.@...@@
@@@.@.@.@.@@.@@@@..@
@.@..@.@@@.@..@...@@
....@@.....@.@.@.@@@
@@@.@..@.@.....@..@@
....@@..@@@.@@..@..@
@.@@@@.@@@.@.@.@..@@
@@@@@..@@@.@.....@.@
@@@@.@.@@....@.@....
@@@.....@.@.@@@..@.@
.@.@.@.@...@@@..@@..
......@@@.@@@@@...@.
.@.@.@@@@@@@@@@.@.@@
@@..@@@@@@@@@@@@....
...@@@@@@@@@@@@@@@@@
7
5 5 0
18 14 0
10 1 0
10 15 1
6 3 1
0 3 2
10 8 2

18 2 0
1 11 0
9 1 0
8 1 1
3 16 1
6 12 2
8 9 2
