width 20
height 20
.@@.@@@.@.@.@@@@@@.@
.....@.......@@@@...
@@@.@..@.@.@...@.@.@
..@...@@@.@@.@......
@...@...@...@@.@@.@.
@@.@.@.@@.@.@@@...@@
@@@....@...@..@@.@@@
@@@@.@@.@.@.@.@....@
@@@...@........@@.@.
..@.@..@.@.@.@......
@....@..@...@@@@.@.@
..@.@@.@@.@.....@.@.
@.@.@@@@@@..@@.@@.@.
...@.@@@...@@.......
@.@...@@@.@.@.@.@.@.
....@..@.@...@.@@..@
.@.@@@.....@.@..@.@.
.@@@@@@.@@.@...@....
...@@@@...@.@@..@.@@
.@@@@@@.@....@@..@@@
7
6 15 0
19 11 0
15 19 0
18 3 1
9 0 1
7 18 2
11 0 2

6 4 0
7 0 0
12 3 0
4 7 1
19 9 1
10 19 2
18 3 2
