width 20
height 20
...@....@.....@@@@@@
.@.@@.@@.@.@.@@@@@@@
.@.@@.@.....@@@@@@@@
@..@....@@.@@@@@@@@@
..@.@.@...@@@@@@@@@@
@....@@@.@@@@@@@@@@@
..@.@@@..@.@@@@@@@@@
@.@@.@.@....@@@@@@@@
.......@@.@..@@@@@@@
@.@@.@....@.@@@@@@@@
..@...@.@.@..@@@@@@.
@@@@.@@@@@..@.@@@@..
..@...@.@.@...@@@..@
@.@@.@......@@.@.@..
..@@@.@.@@@@.@.@...@
.@@@@...@@@......@.@
..@.@.@@.@.@.@.@.@@@
.@@...........@....@
....@.@.@@.@.@@@.@..
@.@..@...@..@@@@@..@
7
6 8 0
12 0 0
4 12 0
5 1 1
0 0 1
9 10 2
4 10 2

1 9 0
2 8 0
4 12 0
0 14 1
12 14 1
8 17 2
16 17 2
