width 20
height 20
....@......@@@@.@..@
.@.@@.@@.@.@@@....@.
..@.@...@@@@@@@.@...
@.@.@.@@.@...@@@.@@.
...........@.@@@....
@@.@@.@@@.@@..@..@@.
@@@......@.@.@.@..@.
@@@@@.@@@......@.@@.
@@@@@..@@@.@.@....@.
@@@@@.@@@...@..@.@.@
@@@@@@@@@.@..@..@@..
@@@@@.@@@@@.@.@....@
@@@@@..@@@.....@.@..
@@.@..@.@.@.@.@@@@.@
@@..@........@.@@.@.
@@@...@.@@.@@.......
@@@@@.@@.@...@.@@.@.
@@@....@...@@@...@@@
@@@@@.@.@@@.@.@.@@@@
@@@@............@@@@
7
6 6 0
2 14 0
6 12 0
3 6 1
9 19 1
18 2 2
19 8 2

9 19 0
6 19 0
3 17 0
17 0 1
17 1 1
18 0 2
16 17 2
