width 20
height 20
........@@@..@@@@...
@.@@.@.@@.@.@.@...@@
@@@.@...........@.@.
@@...@.@@.@.@.@.@...
@@@.@@@.@@@@.@.@.@@.
@@@..@....@.........
@.@.@.@.@@.@.@@.@@.@
.............@@.@@@@
@@.@.@.@.@.@.@.@.@.@
@...@@@...@.........
@@.@.@@@.@.@.@@@.@.@
@@....@.....@.@.@...
@@.@@@.@@.@@..@..@.@
.@.@....@@.@.@.@....
..@@@.@..........@.@
.@.@.@@.@.@@.@@.@...
.......@.@@@@@.@@@.@
@@.@.@...@.@.@......
@..@@.@.@......@.@.@
@@.@......@@.@..@...
7
8 16 0
2 15 0
4 19 0
1 16 1
6 13 1
11 7 2
1 7 2

7 19 0
11 2 0
18 18 0
4 19 1
16 14 1
5 16 2
16 5 2
