width 20
height 20
@@@@@@@@@@@@@@@@@@..
@@@@@@@@.@@@@@@@@..@
@@@@@@@@.@@@@.@@@@..
@@@@@@@@..@@....@..@
@@@@@.@..@@@@.@@.@..
@@@@...@.@@@.......@
@.@.@.@...@..@.@.@..
........@@@@..@.@.@@
@.@.@.@...@..@@.@.@@
...@@.@.@@@.@.......
@.@@.@....@.@.@.@.@.
@@@@...@.@....@@@@..
@@@@@@..@@@@.@@.@@@.
@@@@...@.@.@.@...@..
@@@@@.@.....@.@.@.@.
.@@@....@.@.........
..@.@.@.@@.@.@@.@.@.
.@..@..@....@.@@...@
...@.@.@.@@.....@.@.
@@.......@..@.@@@...
7
19 9 0
18 2 0
19 16 0
2 19 1
19 14 1
14 6 2
2 9 2

4 5 0
11 8 0
17 8 0
5 14 1
1 9 1
17 17 2
10 13 2
