width 20
height 20
.@.@.@.@@.@@@.@...@@
...........@....@@.@
@.@@.@.@@.@.@.@.@...
..@@@@@........@@@.@
@..@@@..@.@.@.@@@...
..@@@@@.@..@..@@.@.@
.@@@.....@@@@.......
@.@.@.@.@.@.@.@.@.@.
@....@..@....@.@.@..
..@.@.@..@.@.@.@.@@.
@@......@@@.........
@@@.@@.@@@.@.@.@.@.@
@..@..@@@.....@.@.@.
..@.@....@.@.@......
@....@@.@@@@...@.@@.
.@.@@....@.@.@@@.@@.
.@...@.@...@@...@...
...@@...@@.@..@@..@.
@.@.@@@.@....@@.@.@.
.........@.@......@.
7
0 6 0
13 4 0
13 0 0
12 12 1
2 12 1
1 7 2
17 6 2

13 14 0
17 19 0
4 10 0
2 16 1
0 1 1
1 2 2
19 9 2
