width 20
height 20
@@@@@.@.@@.@.@.@....
@@@@@...........@.@.
...@@.@@.@.@@.@....@
@@.@.@@.@@@.@@@@.@.@
..........@.@.@@@...
.@.@.@@.@@........@.
.@@.@@@....@.@@.@..@
.....@.@.@.@@@@@.@.@
.@.@@...@.@..@@..@..
@....@@.....@...@@@.
.@.@.@.@.@@@..@.@@.@
...@......@.@.@.....
.@.@@.@.@......@.@.@
..@.@..@..@.@@..@@.@
.@...@.@@@.@...@....
@@@.@.@@.@...@.@.@.@
@..........@..@..@@@
@.@@.@.@.@..@@..@@..
....@.@...@@@@@....@
@.@...@@.@@@@@..@@..
7
18 2 0
1 18 0
13 5 0
4 19 1
6 11 1
1 7 2
11 1 2

1 9 0
13 14 0
1 17 0
17 4 1
17 0 1
15 19 2
13 5 2
