width 20
height 20
@@..@....@@@@@@@.@@@
@@.@.@@.@.@.@@.@..@@
......@..........@.@
@.@@.@.@.@.@.@.@....
@@......@.@.@.@.@@.@
...@.@.@............
.@.@@....@.@.@.@@.@@
..@..@.@..@@..@.....
.@..@.@@.@@@@@@@.@.@
...@@.@.....@..@.@.@
.@.....@@.@...@.@.@.
@.@.@.@@...@@.......
....@..@@.@@.@@.@@.@
.@@.@.@...@.......@@
...@.@@@.@.@.@@.@.@@
.@.....@.@....@@@.@@
@..@.@..@@.@.@@.....
@@@..@@@....@...@.@.
@@.@....@@.@.@@@@@@.
@@...@.@@@....@@@@..
7
16 1 0
9 5 0
3 8 0
18 2 1
14 5 1
13 9 2
6 6 2

15 2 0
17 16 0
14 11 0
4 10 1
14 3 1
16 2 2
0 14 2
