width 20
height 20
@......@....@@..@@@.
@@@.@@@.@.@@.@.@.@..
.....@.............@
@@.@@.@.@.@.@.@@.@.@
....@....@..@@@@.@.@
@.@...@.@..@....@...
..@.@..@.@...@.@.@.@
.@.@.@.@...@..@..@.@
.....@@.@.@@.@@@.@..
.@@.@@...@.@..@....@
...@...@@....@@@.@@.
.@@@@@.@.@.@..@.....
..@@.....@..@.@.@.@.
@.@@@@.@@@.@...@.@..
.@.@......@.@.@@.@@.
....@.@.@...@@@..@..
.@.@.@@@@.@..@.@.@@.
@..........@........
@@.@.@.@@.@..@.@.@.@
@@..@..@..@@.@..@...
7
7 15 0
10 17 0
12 10 0
0 2 1
9 7 1
9 18 2
2 3 2

18 3 0
1 17 0
12 18 0
9 2 1
16 16 1
0 8 2
14 17 2
