width 20
height 20
@@@....@.@@@..@.....
@@..@.@...@.@.@@@@.@
@@@.@...@...........
@@@.@.@..@.@.@@.@@.@
.@.@.@@.@..@..@@...@
.........@..@.@@@.@.
@.@.@@.@.@.@@@....@.
..@...@...@@@@@.@...
@..@@@@@.@@@.@.@@.@@
..@.@.@@@.@....@@@..
@.@.......@@.@.@.@.@
....@.@.@.@@@@......
@.@..@@@@@.....@@.@@
@@@@..@.@.@.@@@.....
@@@@@.......@...@.@@
@@@@@@.@@.@.@@.@@@@@
@@@@@@@....@@@..@@@@
@@@@@@@.@.@.@.@..@@@
@@@@@@...@......@@@@
@@@@@@@.@@.@.@@@@@@@
7
11 1 0
5 14 0
8 0 0
19 0 1
11 14 1
14 8 2
15 6 2

1 11 0
4 13 0
11 15 0
5 13 1
5 14 1
6 10 2
17 7 2
