width 20
height 20
@@@...@.@@.@@@@.@.@.
@..@@......@@@......
@@.@.@.@.@.@.@.@.@.@
......@.@.....@..@..
.@.@@....@.@.@.@..@.
.@@...@.@@@......@.@
.@.@.@.@.@.@.@.@...@
@..........@@..@.@..
@@.@.@.@.@...@..@..@
@.@@@.@@.@@.@.@@.@..
....@.@..@.......@.@
@.@@...@@.@.@@.@....
...@@.@@...@@@..@.@.
.@......@.@@@..@.@..
@.@.@@@....@.@....@.
@...@@@@@.@....@@..@
..@@.@@.@..@@.@...@@
@........@.@..@@@.@@
.@.@.@.@@.@.@...@@@@
....@.........@@@@@@
7
14 1 0
14 6 0
13 5 0
2 10 1
7 17 1
11 5 2
16 13 2

12 17 0
16 1 0
7 19 0
5 19 1
0 18 1
14 15 2
10 1 2
