width 20
height 20
@@@@@@@...@@...@.@..
@@@@@@@@.@@.@.@....@
@@@@@@@...@....@@@.@
@@@@@.@.@...@.@@.@.@
@@@@...@..@@..@.....
@@@@@.@.@.@.@@.@.@@.
@@@@.............@..
.@@@@.@.@.@.@@.@..@@
.@@@..@@.@....@@.@.@
.....@.@.@@.@..@.@..
@.@@.....@@@..@..@.@
@.@@@@@.@.@.@@.@....
@@@@@@@@.........@.@
@@@@@@@@@.@.@@.@@...
@@@@@@@....@@@@@@.@.
@@@@@@@@@.@.@@@@.@@@
@@@@@@@...........@@
@@@@@@@@.@.@.@.@.@@@
@@@@@@@@@...@@@....@
@@@@@@@@@@.@@@@@.@..
7
19 19 0
9 14 0
11 18 0
19 9 1
10 14 1
11 1 2
16 4 2

17 18 0
6 10 0
19 0 0
8 17 1
9 13 1
4 4 2
16 6 2
