width 20
height 20
@@.@@@@@@@@@.....@@@
@@.@@@@@.@@.@@.@..@.
@....@.......@..@@..
..@.@@@@@.@@...@..@.
.@.@..@.@@@@@.@.@...
.....@...@......@@@.
.@@@.@@.@.@.@.@.....
@@@........@..@@@.@.
@..@@.@@@.@.@.@@@@..
.@...@@........@@@@.
...@.@.@@.@.@.@.....
@@.@.....@@@@@@@@.@.
....@.@.@.@.@@@....@
.@.@..@......@..@@..
..@..@..@.@@@@@@...@
.@@@@.@.@@@.@@@@@.@@
@@@......@...@@@....
@@@@@@@.@.@.@.@.@.@.
@.@.@.............@.
......@.@.@.@.@@.@..
7
14 0 0
12 13 0
2 1 0
17 1 1
4 16 1
15 18 2
9 14 2

17 7 0
9 7 0
18 19 0
10 9 1
17 4 1
10 2 2
13 5 2
