width 20
height 20
................@...
........@...........
.......@............
...@.......@........
....................
.........@....@.@.@.
......@.@...........
...@........@.@.@...
...........@.@.@....
........@...........
....................
..............@.@...
.......@............
.................@..
...@......@.........
...............@..@.
.....@......@.......
........@........@..
@...................
@..............@....
9
8 8 0
4 3 0
0 14 0
10 5 1
3 16 1
16 9 1
3 9 2
5 2 2
6 9 2

18 19 0
15 17 0
19 17 0
19 2 1
6 5 1
19 11 1
15 2 2
12 15 2
18 1 2
