width 20
height 20
......@@@@@.........
.@.....@..@.........
....................
..@......@...@......
@.@@................
@.....@....@....@...
....................
....................
@....@............@.
@.............@.....
@....@....@.........
.............@.....@
...@.@.............@
.............@....@.
@@...@..@......@....
....................
....................
..@..@..@.@........@
...................@
...@...............@
9
9 15 0
6 16 0
16 16 0
3 9 1
17 6 1
17 19 1
6 1 2
2 10 2
12 9 2

9 14 0
7 7 0
17 17 0
19 16 1
0 17 1
11 0 1
10 16 2
16 0 2
1 18 2
