width 20
height 20
............@.......
....................
.............@......
..@.@...@@@.@.......
....................
.........@....@.....
@..............@....
.............@...@.@
.........@.@........
....................
..@.@.@..@...@......
.................@@@
....................
..........@.........
......@......@.@....
...@.......@........
................@...
........@.........@.
....................
@................@@@
9
16 10 0
5 13 0
13 11 0
10 10 1
10 0 1
10 6 1
4 6 2
7 3 2
3 13 2

17 13 0
4 12 0
0 0 0
8 1 1
15 8 1
4 19 1
18 16 2
1 11 2
17 15 2
