width 20
height 20
....................
....................
.....@..............
....@...@.@..@....@.
....................
..@...@.............
....................
..@......@....@.....
..........@.@......@
................@...
....@...@..@......@.
.............@......
...............@....
....@....@....@.....
....................
@@@................@
@@....@.........@...
@@@....@....@.......
@@@.................
@@@...@.............
9
3 2 0
7 15 0
0 13 0
7 8 1
19 11 1
17 13 1
14 8 2
15 16 2
18 13 2

19 19 0
9 15 0
18 11 0
19 0 1
3 4 1
1 1 1
13 6 2
0 0 2
1 6 2
