width 20
height 20
....................
....................
........@....@......
.......@..........@.
...@.......@.@......
..........@.....@...
....................
....@.....@.........
.........@.......@..
..@..@....@........@
....................
..@............@....
...@......@.........
........@..@.@...@..
...@................
.........@.....@..@.
.............@......
@.......@...........
@..................@
@@.................@
9
6 15 0
14 12 0
1 17 0
2 0 1
5 13 1
10 10 1
14 15 2
6 17 2
10 11 2

10 2 0
0 1 0
12 7 0
12 8 1
18 0 1
11 2 1
0 2 2
15 3 2
10 14 2
