width 20
height 20
...................@
.................@..
.....@..@...........
................@...
......@.............
.......@.@..........
............@.......
................@...
..@.................
...........@..@.....
......@.............
...........@...@....
.......@.......@@.@.
....................
.........@..........
...............@....
.......@.........@..
.........@.....@....
.@..................
.@@.................
9
0 5 0
0 6 0
4 10 0
18 16 1
12 8 1
1 3 1
2 13 2
7 18 2
9 13 2

0 3 0
19 1 0
9 10 0
0 16 1
3 17 1
6 5 1
4 15 2
5 19 2
9 1 2
