width 20
height 20
....................
.................@..
.......@............
........@.@..@...@..
.@...........@@.....
...........@..@.....
.@.....@........@...
..........@.........
.............@......
.@.@......@.....@...
......@.............
..................@.
..@.................
............@.......
..@.......@.....@...
@.....@.@.....@.....
...............@....
....@...............
...................@
@...@@.......@@@@@@@
9
1 0 0
10 0 0
0 3 0
12 4 1
4 16 1
6 5 1
1 11 2
10 6 2
4 9 2

18 6 0
12 7 0
15 4 0
8 19 1
13 13 1
18 4 1
8 7 2
10 5 2
3 8 2
