width 20
height 20
@@@..............@@@
........@........@@@
..........@.........
@@.@........@.......
...........@...@..@.
....@...............
@.........@...@.....
....................
..@.......@..@......
...@.@..............
................@...
....@.@..@...@......
..........@.....@...
.....@..............
.......@...........@
.........@...@.@....
...........@........
@@..@..@............
@..........@.......@
...............@....
9
12 15 0
14 3 0
15 0 0
13 14 1
0 12 1
10 16 1
9 14 2
17 17 2
9 2 2

12 15 0
3 19 0
15 7 0
3 16 1
5 1 1
1 19 1
10 13 2
1 5 2
19 19 2
