width 20
height 20
.......@...@........
@....@..............
....@.@...@.@.......
....................
...@......@.@.......
....@....@.........@
.............@......
.@..........@.......
...@..@..@........@.
..................@.
.........@..........
....@.@.@...........
...@................
..............@.....
...............@....
........@.@.@.@.....
....@...............
....................
..........@.....@@@@
......@@.......@@@@@
9
5 2 0
12 19 0
13 4 0
0 5 1
3 6 1
2 12 1
0 15 2
1 15 2
15 9 2

11 11 0
1 13 0
6 16 0
9 9 1
1 2 1
16 2 1
12 11 2
17 12 2
12 16 2
