width 20
height 20
@@@@@@@.....@.......
@@@@@@@@............
@@@@@@.....@......@.
@@@@@@..............
@@@@@@..........@...
.@@@@@..............
............@.@.....
..@.................
............@..@....
....@...@.@.........
....................
.....@...@..........
............@....@..
...@......@.........
..@.................
.@..........@.......
............@.......
.................@..
............@.......
....................
9
13 10 0
14 10 0
9 12 0
2 10 1
15 19 1
17 11 1
12 13 2
15 2 2
16 5 2

6 7 0
14 9 0
14 8 0
3 9 1
0 6 1
9 2 1
1 6 2
16 16 2
2 15 2
