width 20
height 20
@@@.................
@@@............@....
@@@@.@...@..........
...............@....
....................
............@.......
...@.....@..........
...@........@@@...@.
@..@................
...............@....
........@...........
..@.......@..@......
...@..........@.@...
.@................@.
.............@@.....
........@...........
..............@....@
....@..@..@.........
...............@....
....................
9
8 18 0
8 14 0
19 14 0
16 0 1
2 15 1
6 15 1
5 7 2
14 6 2
8 5 2

16 15 0
8 14 0
19 1 0
0 17 1
4 10 1
2 18 1
6 2 2
12 6 2
16 2 2
