width 20
height 20
..................@@
..................@@
............@.....@@
....@.............@@
...............@..@@
@....@...@....@...@@
..@.......@..@.@....
....................
................@...
.....@..............
..@......@.....@....
.......@..@..@......
....@...............
.....@....@.........
..............@..@..
..@.@...............
....................
....@............@..
......@...........@@
.........@........@@
9
17 7 0
11 11 0
17 4 0
17 12 1
12 12 1
13 7 1
14 17 2
2 2 2
1 15 2

8 5 0
4 2 0
19 14 0
3 0 1
17 1 1
2 2 1
15 8 2
17 11 2
3 10 2
