width 20
height 20
@...@.....@........@
.......@...........@
....................
@..........@........
......@..@......@...
....................
@..@................
.@..................
...@........@.......
.............@......
...........@....@...
........@.@....@....
..@.@......@........
............@.......
...............@....
.....@@.@......@@.@@
...................@
..............@....@
...@................
.@......@...........
9
2 14 0
15 0 0
5 7 0
19 18 1
4 5 1
4 1 1
18 8 2
7 5 2
9 19 2

18 0 0
4 15 0
13 19 0
12 9 1
3 12 1
14 8 1
0 17 2
19 19 2
0 11 2
