width 20
height 20
@......@@@..........
....................
....@@..............
..@..@..............
.......@............
.........@...@..@...
....................
.........@....@.....
..@.............@...
......@.............
.......@............
..........@....@....
....................
...........@.....@..
.....@....@..@......
.........@.....@...@
...................@
.....@..............
....@..@............
....................
5
2 9 0
0 6 0
14 2 0
19 11 0
13 8 0

14 0 0
8 11 0
13 4 0
14 19 0
5 15 0
