width 20
height 20
....................
.....@........@.....
..@........@.@......
.....@..............
....................
........@.@.........
.............@..@.@.
..@.................
..............@.....
....@.@..@..........
.@..................
....@..@....@.......
........@....@......
...@................
........@........@..
.....@....@..@......
........@.@.@...@...
@@.......@..........
@@................@.
@@@@..........@.....
5
17 4 0
9 6 0
19 8 0
16 11 0
19 12 0

6 12 0
9 6 0
6 10 0
16 11 0
1 0 0
