width 20
height 20
.@......@...........
.@........@...@.....
....................
.@..@...............
.......@.@.........@
..........@.........
...@.......@...@....
.....@.......@......
.........@..@..@...@
....@..............@
............@......@
...@.............@..
.............@......
....................
@.....@.............
@@.........@...@..@.
@@.....@............
................@...
........@.........@.
....................
5
6 3 0
13 0 0
14 12 0
8 8 0
14 18 0

18 14 0
14 9 0
14 12 0
18 1 0
14 19 0
