width 20
height 20
@...................
................@...
.........@..........
....@.@....@........
........@........@..
.........@..........
.....@..............
....................
.@...@.@............
........@...........
...............@....
..@.......@...@.....
...........@.@......
......@.............
...@...........@....
....................
..@.@....@.@....@...
............@....@..
........@...........
......@.............
5
8 17 0
3 15 0
3 16 0
3 12 0
19 15 0

6 6 0
18 0 0
15 8 0
6 2 0
11 17 0
