width 20
height 20
.....@.....@@@@...@.
...........@@@......
.........@.@@@@..@..
....@..@.....@......
........@...........
.....@..............
.......@......@.....
.@.@.....@..@......@
...................@
.....@....@.........
....@...@...........
....................
..@........@........
....@...............
..........@.....@.@.
@.@.................
.@....@.....@.......
.............@..@...
.....@@.............
@....@@@............
5
3 15 0
2 6 0
2 13 0
9 17 0
13 13 0

2 9 0
16 5 0
19 17 0
1 4 0
4 11 0
