width 20
height 20
@@@@@.......@@......
@@@@@...@..@@@....@.
@@@@@......@@@...@..
@@@@........@@......
@@@@.......@........
@@@@............@..@
@@@......@..@.......
...@............@...
....................
....@..@.........@..
..@...........@.....
.......@............
...@.........@..@...
.......@............
....@.....@.........
..............@.....
......@.............
...@..........@.....
........@...........
@@...............@..
5
18 12 0
6 5 0
18 0 0
3 15 0
4 6 0

10 15 0
10 9 0
7 18 0
10 1 0
8 12 0
