width 20
height 20
@.@@...........@@@..
.....@........@.....
...........@........
......@.............
........@........@..
....................
..@.........@....@..
....@......@........
.....@.@............
......@..@....@.....
...........@.......@
............@......@
...........@.....@..
...@...........@....
.......@............
...........@.@.@....
........@.......@...
....................
......@.............
....................
5
0 15 0
19 18 0
15 2 0
14 12 0
7 6 0

18 12 0
12 17 0
10 10 0
13 12 0
15 16 0
