width 20
height 20
....................
.................@..
......@......@@@....
.................@..
..@...@.............
@............@.....@
.........@.....@...@
..................@.
....................
...@.@....@...@.....
......@....@....@.@.
...@................
...........@........
.....@........@.....
@..@.......@........
@.............@.....
@.....@.........@...
@@..................
@@@@@.........@.@@@@
@@@@@........@@@@@@@
5
2 12 0
5 5 0
17 11 0
17 16 0
10 15 0

7 13 0
6 12 0
7 10 0
8 13 0
15 14 0
