width 20
height 20
....................
....................
..........@.....@.@.
.....@.......@......
.........@.@...@....
.@......@........@..
...@.......@........
.....@......@.......
..........@....@..@.
.....@..@@.......@..
....................
............@..@....
...@.@..............
......@.@.....@.@...
.............@......
....................
..@..............@..
.............@......
@.......@...@.......
@........@..........
5
1 4 0
19 15 0
13 10 0
2 3 0
13 15 0

19 19 0
3 3 0
18 1 0
17 7 0
18 3 0
