width 20
height 20
.......@......@....@
....................
...................@
.....@...@..........
............@.......
...............@..@.
.....@.......@......
....@...............
.....@...@..@...@...
...................@
......@....@........
....@.....@.........
..............@.....
...............@....
........@......@..@.
....................
...@...@..@.@.......
........@..@........
....................
.......@@@..........
5
18 10 0
10 9 0
15 15 0
9 15 0
3 5 0

1 18 0
3 17 0
13 0 0
3 13 0
3 0 0
