width 20
height 20
........@@.....@....
.@.............@....
...........@........
..............@.....
...@.@....@........@
..............@....@
...........@........
.......@............
...@....@.........@.
...............@....
.......@............
...@......@..@......
....................
...@.@......@.......
..@.......@..@......
....................
............@..@....
....................
....@..........@....
.........@..........
5
14 10 0
13 12 0
4 5 0
9 6 0
10 19 0

1 8 0
11 1 0
11 0 0
7 15 0
10 19 0
