width 20
height 20
....................
..@.@...............
....................
.........@.@........
.............@.@@...
..@......@..........
...@..@....@...@....
.......@.........@..
....................
....@...............
..@....@............
..........@....@..@.
....@@@.....@.......
....@@....@...@.....
....@...............
....................
..@..@.@..........@.
....................
.........@..........
......@@@@@@@....@..
5
1 9 0
10 12 0
13 8 0
6 9 0
2 4 0

5 9 0
3 1 0
8 13 0
9 9 0
19 19 0
