width 20
height 20
....................
...............@....
..........@.@.......
..@......@..........
.................@..
....................
..@.@....@..........
..............@.@...
@@.................@
@.....@.....@.....@@
@.............@....@
....................
@...................
..........@.........
..................@.
.............@......
.@..............@...
.......@@...........
@...@@@@@.....@.....
@...@@@@@@..........
5
16 13 0
18 5 0
9 0 0
7 1 0
14 3 0

3 18 0
15 19 0
7 0 0
3 19 0
4 16 0
