width 20
height 20
................@...
....................
...@.@......@.......
...............@.@..
.......@.@.@........
...@....@.@.....@...
....................
.........@..........
..@@@......@..@.....
..@.................
.........@.......@..
.@....@.............
.....@......@.......
......@..@..........
...............@....
..@..............@..
......@...........@@
....@..@......@.....
................@...
@@.@................
5
3 1 0
5 4 0
10 10 0
9 3 0
13 15 0

3 0 0
1 9 0
17 7 0
19 18 0
5 18 0
