width 20
height 20
..........@@@...@...
....................
..@.................
......@...@.........
..@....@....@.@.....
..................@@
.@......@..........@
.............@...@.@
....@.....@...@....@
.........@......@...
.......@......@.....
..@.@..........@....
.....@..............
.............@......
................@...
@................@..
....@.....@....@....
......@..@..........
....................
......@@.......@@@..
5
5 17 0
10 11 0
13 18 0
14 3 0
11 7 0

11 3 0
13 11 0
17 1 0
17 13 0
2 18 0
