width 20
height 20
...................@
.......@...........@
....................
....................
...........@......@.
.......@.......@....
....................
.....@..............
.......@..@...@.@..@
.............@.....@
..@.@..............@
...........@..@....@
................@..@
....@..............@
.@..............@...
..........@......@..
....................
@.@........@..@.....
@@@@@@@...@.........
@@@@@@@@............
5
5 5 0
10 2 0
10 13 0
0 5 0
10 12 0

4 12 0
5 14 0
4 6 0
13 14 0
17 2 0
