width 20
height 20
.............@......
.@..................
........@....@......
.........@..........
..@.................
.@...@....@.........
......@..@.....@....
....@...@...........
...@................
....................
.......@...@........
........@....@...@..
.........@@.........
.@.......@@.........
.....@.@..@....@....
....................
.............@.@....
....................
......@.............
.@@@...@@...........
5
4 17 0
10 16 0
2 2 0
1 10 0
0 4 0

2 2 0
8 15 0
5 4 0
4 11 0
19 17 0
