width 20
height 20
................@@@@
....................
...@......@.........
....@............@..
.@..................
.....@.......@......
.........@.....@....
....................
.@..................
..............@.@...
...........@........
...@.........@.@@@..
....@..........@@@@@
................@@@@
...@..@....@.@....@.
....................
......@.............
@................@..
@.@.@...............
@.@.................
5
8 2 0
4 9 0
4 16 0
18 2 0
16 8 0

18 18 0
17 19 0
14 15 0
3 16 0
14 17 0
