width 20
height 20
@@..@@...........@@@
@@.@@@......@.......
....................
@....@.........@....
....................
....................
.@...@...@....@.@..@
.............@.@....
..........@.........
.........@.@.@..@...
....................
...@..@.............
..@...@.............
....................
.............@......
...@....@.@......@@@
.......@.........@@@
...............@@@@@
.........@....@@@@@@
..............@@@@@@
5
16 11 0
7 15 0
17 13 0
4 14 0
11 17 0

3 7 0
12 0 0
7 7 0
6 6 0
10 17 0
