width 20
height 20
@@.......@@.........
@@....@.............
@@....@.............
@@.@@@.........@....
.....@...@..........
.............@......
....................
..@...@...@...@.....
..@.@...............
..............@.@...
@@@@@........@....@.
..........@.........
....@.............@.
...@.........@......
....@....@......@...
.......@..@.......@@
........@..@.......@
................@...
@...................
.........@..........
9
3 1 0
13 14 0
17 2 0
8 12 0
8 13 0
0 14 0
11 4 0
9 5 0
19 4 0

1 7 0
8 0 0
1 15 0
19 6 0
18 2 0
10 1 0
4 4 0
9 9 0
3 5 0
