width 20
height 20
.............@@@@...
.................@.@
....@...............
.@..................
......@............@
....@............@..
.....@.....@..@....@
.@.....@.@..........
...............@....
...........@........
.........@......@...
.@.....@............
.....@...@...@......
.................@..
.............@.@....
.@..@..@............
..@.......@........@
.......@@.......@...
.............@...@..
...@......@.......@@
9
5 5 0
18 9 0
12 18 0
4 10 0
1 5 0
11 13 0
15 19 0
11 14 0
18 7 0

18 17 0
17 9 0
11 18 0
16 19 0
9 18 0
2 0 0
1 1 0
11 14 0
6 15 0
