width 20
height 20
....................
.........@..........
.....@..........@...
....................
...............@....
........@.......@.@.
......@.............
..........@.........
.@.@........@.......
...........@...@....
......@.............
.........@..@.......
...........@....@.@@
..........@.......@@
.....@........@...@@
.......@....@.....@@
....................
.@...........@......
.....@............@.
....................
9
14 7 0
5 3 0
19 19 0
5 16 0
4 2 0
4 0 0
0 10 0
10 12 0
9 15 0

2 11 0
17 9 0
15 12 0
17 6 0
16 16 0
10 15 0
19 0 0
9 13 0
13 12 0
