width 20
height 20
....................
.@.@.@..............
.......@.....@......
.........@.@......@.
@...................
............@.@.....
....@...............
..@.......@...@..@..
.......@............
....................
@..@................
@.......@......@....
....................
.....@..........@...
....@.....@.........
....................
.......@.@....@..@..
..@.......@.........
...@................
....................
9
8 3 0
6 15 0
5 7 0
4 16 0
16 18 0
17 6 0
15 9 0
5 18 0
12 17 0

13 13 0
6 16 0
11 0 0
4 12 0
9 8 0
0 19 0
3 11 0
5 18 0
14 12 0
