width 20
height 20
@@@@@@............@@
@@@.....@.........@@
..@...........@.....
.@........@.........
....................
.......@.@..@..@.@..
...@................
.........@.....@....
........@...........
......@......@..@...
....................
........@...@....@..
...............@....
...........@........
...............@....
.......@.....@..@...
..@.................
@....@.......@......
.....@...@.@........
@...@@@....@........
9
12 2 0
2 17 0
11 7 0
11 0 0
4 10 0
9 14 0
0 14 0
9 15 0
6 12 0

6 5 0
9 2 0
0 11 0
0 18 0
5 12 0
11 14 0
11 5 0
16 7 0
8 19 0
