width 20
height 20
....@.........@.....
....................
......@.....@.......
........@..@.......@
.............@..@...
....................
...............@....
..@..@....@.........
....................
@.............@.....
@@@..............@..
@@@.........@.@.....
......@..@.........@
..........@..@.....@
..............@....@
.@..................
.@.@....@.....@.@@@@
.........@..@...@@@@
....@.@.........@@@@
................@@@@
9
7 18 0
6 3 0
13 16 0
0 19 0
15 0 0
17 14 0
13 11 0
5 5 0
0 1 0

18 5 0
3 5 0
14 4 0
12 4 0
6 10 0
17 15 0
0 3 0
2 4 0
5 1 0
