width 20
height 20
.@@@.....@..........
....................
.@..................
....................
.............@......
.......@..........@.
.........@..........
...@..........@....@
..@.@......@.......@
.....@...........@.@
@.......@...........
@...................
@........@...@......
.@..@.....@....@@@@@
............@@@@@@@@
...........@@@@@@@@@
....@..@....@@@@@@@@
.............@@@@@@@
.............@@@@@@@
..............@@@@@@
9
15 11 0
5 19 0
11 12 0
9 2 0
4 7 0
8 18 0
11 17 0
6 8 0
15 6 0

0 18 0
16 3 0
0 0 0
17 12 0
19 0 0
0 3 0
16 11 0
17 3 0
7 15 0
