width 20
height 20
....................
...@.............@..
..........@.@.......
.................@..
.....@..............
...............@....
....@....@...@.@....
..@.........@.......
..............@.....
....................
...@............@...
.....@.@.....@.@....
...@..@..@..........
...@................
.......@...@........
....................
....@......@.@....@.
....................
....................
....................
9
14 10 0
7 1 0
8 15 0
9 3 0
7 15 0
15 14 0
7 16 0
6 13 0
12 19 0

3 0 0
14 15 0
4 0 0
2 12 0
19 5 0
15 9 0
18 11 0
19 3 0
1 1 0
