width 20
height 20
@......@.......@....
@..............@.@..
...@.@..............
..@.......@...@..@..
...@..@.....@.......
....................
...@..............@.
..@...@.............
....................
...@......@.@.......
@.......@.......@...
@............@......
@..............@..@.
@.@........@........
....@.....@.........
.....@............@@
..................@@
.........@..........
............@.......
...................@
9
18 14 0
11 17 0
19 2 0
5 6 0
8 3 0
0 8 0
11 16 0
9 3 0
18 7 0

11 1 0
19 3 0
17 2 0
14 8 0
7 4 0
9 16 0
12 16 0
18 18 0
1 15 0
