width 20
height 20
...@.@..........@@@@
................@@@@
@@.@...@............
@@..@...............
@....@.......@.@....
@...................
@..........@.@......
....@..........@....
.@...@..@..@........
..........@.........
....................
....@.@.....@@......
...........@@@......
......@..@..........
...@...........@....
.........@......@...
.................@..
......@........@....
..@....@............
....................
9
17 15 0
4 6 0
2 0 0
13 8 0
19 17 0
11 10 0
8 12 0
9 7 0
13 3 0

12 16 0
1 4 0
11 0 0
18 18 0
6 4 0
1 17 0
17 2 0
4 18 0
8 10 0
