width 20
height 20
....................
...@................
.....@..@...........
...............@.@..
....................
...@.......@........
....@...............
.............@@.....
.......@.....@....@@
..@.....@..@........
....................
.....@.....@....@...
.......@.@..........
..........@.@.......
..................@.
.............@......
.......@.@.....@....
...@..........@@@...
.........@..........
.................@@@
9
1 10 0
8 15 0
13 19 0
14 4 0
4 1 0
17 15 0
4 5 0
9 3 0
5 16 0

12 12 0
16 15 0
15 7 0
4 17 0
5 0 0
1 0 0
4 9 0
1 19 0
16 1 0
