width 20
height 20
.@........@@........
.@.@.@..............
...........@........
@@..................
........@...@.......
...@............@...
......@.............
..........@...@.@...
...@..@.............
.@...@..............
..........@@........
........@..@@.@.....
....................
..@.@...@....@......
............@.......
........@.......@...
...@...@......@.....
.......@.......@....
@.....@@............
@...................
9
8 0 0
15 7 0
12 9 0
18 0 0
11 4 0
14 9 0
3 17 0
9 8 0
14 15 0

13 11 0
11 16 0
17 17 0
16 3 0
5 10 0
4 18 0
1 13 0
19 17 0
11 12 0
