width 20
height 20
.@............@.@@@@
..................@@
...........@...@....
...@................
......@..@..........
.............@......
................@...
..@....@....@.......
.................@..
.......@..@.@.@.....
....................
....................
@@@.@...............
@@@..........@......
@@...@.....@..@.....
............@.......
............@.......
.....@.@............
..@........@.@......
.........@..........
9
9 1 0
18 11 0
0 10 0
16 16 0
10 3 0
4 5 0
16 4 0
17 12 0
9 17 0

10 13 0
13 16 0
12 19 0
13 0 0
11 5 0
19 5 0
5 19 0
9 1 0
17 18 0
