width 20
height 20
@@@@@@@.@@@.@..@.@..
@@.@@@....@...@@.@.@
@...@.@.@@.@@.......
.@.@@.........@@@@.@
.....@.@.@@.@.@...@@
.@@@.@.@@@@@.@..@..@
..@.@@...@@@..@@.@.@
.@...@.@..@..@.....@
...@..@@.@@.@.@@@@..
@.@.@.@.........@..@
.@.....@@.@.@.@@.@..
...@.@...@@.@......@
.@.@..@.@@.@..@.@.@@
..@@@.@@.@..@@...@@@
.@.@.@.@.@.@@.@.@@@@
................@@@@
@.@.@.@.@.@@.@@..@@@
@@...@.@....@.@.@@@@
@.@.@@.@@@@....@@@@@
........@...@.@@@@@@
2
0 8 0
4 5 1

15 4 0
3 6 1
