width 20
height 20
.@..@..@@@@@@@@@@@@.
...@.@.@@@@@@@@@@@..
.@.....@@@@@@@@@@.@.
..@.@.@.@@@@@@@.....
.@.@.@...@@@@@.@@.@.
.....@.@.@@@@.....@.
.@.@..@@.@@@@@.@.@..
..@@.@.....@@@@..@@.
.@@....@.@.....@.@@@
@...@@@@..@@.@....@@
@.@.@@@..@@.@@@.@.@@
...@@@@.@.@.@@.@@@@@
@.@.@.@........@@@@@
.@......@.@@@.@@@@@@
.@@.@@.@..@.@.@@@@@@
..@...@.@...@.@@@.@@
.@.@.@..@.@..@@@...@
....@..@.@..@.@.@.@.
@@.@.@.@.@@.@.@.....
................@.@@
2
10 7 0
17 2 1

8 7 0
4 16 1
