width 20
height 20
@@@@@@@...@@@@@@@@@@
@@@@@@@.@.@@@@@@@@@@
@@@@.@.@@.@@@@@@@@@@
@@@@.......@@@@@@@@@
@@@..@@.@.@.@@@@@@@@
@@..@@@@..@..@@@@@@@
@@.@.@@.@@..@.@@@@@@
@@......@@@...@@@@@@
@.@@.@@..@.@@.@@.@@@
....@@.@..........@@
@.@@@....@.@.@.@.@.@
...@..@@@.@@@@@.....
@.@.@.@.@.@@.@.@@.@.
................@.@.
@.@.@@.@.@@@.@.@.@@@
...@..@.@.@.@.....@.
@.@.@.........@.@...
@@..@.@.@.@@.@@@..@.
@@@....@..@.@.@@@@..
@@..@.@@@.....@@@@@.
2
5 17 0
9 0 1

10 8 0
8 9 1
