width 20
height 20
...@.@.@............
.@.......@@@.@.@@.@.
..@@.@.@.@@@@..@@@..
.@@@@.@.@.@@.@@@@.@.
@.@@..@.............
@....@@.@.@.@@.@.@@.
.@.@.....@@@@.@.@...
.@..@.@.@@@.......@.
..@@...@@@@@.@.@.@@.
@.@.@.@@@@@..@..@.@.
......@@@@.@..@.@.@.
.@.@.@@@@..@@@@...@.
..@...@@@.@...@@.@@.
.@.@.@.@..@.@@.@..@@
@@......@........@.@
@@@@.@.@@@@@.@.@....
.@.@..@@@@....@@@.@.
.....@@@@@@@.@@@@@..
.@.@..@@@@@@@@@@..@.
..@..@@@@@@@@@@@@...
2
19 4 0
5 4 1

16 11 0
15 14 1
