width 20
height 20
@..@@@@..@.@@@@@@@@@
@.@.@.@@....@@@@@@@@
.........@.@@@@@@@@@
@.@.@.@@@...@@@@@@@@
..@.@.@@@@.@.@@@@@@@
@..@..@@@@@...@@@@@@
@@..@.@@@@@@.@.@.@@@
@@@@......@@.....@@@
@.@.@.@@@@.@.@.@@.@@
..............@@...@
.@@.@@.@.@@.@....@..
@.@...@.@.@@@@@@.@@.
....@........@..@...
@.@.@.@.@@.@.@.@.@@.
..@..@.@....@.......
@.@.@@.@@@.@@@.@@.@.
...@@.......@.@@.@..
.@.@..@.@.@@.....@@.
@@@..@...@@@.@@.@.@.
@@@@.@@.@@@@@.......
2
2 9 0
16 9 1

19 19 0
13 19 1
