width 20
height 20
@@@@@.@.@.@@..@@....
@@@.......@.@.@..@@.
@...@.@.@......@.@@@
..@..@.@..@.@@....@.
@.@.@@.@@@...@@.@...
@.@@@..@.@.@.@@@@.@.
@@.@.@....@.@.@.@@..
@......@.@.........@
..@.@.@....@.@@.@.@.
@..@.@..@.@.@.@@....
..@...@.@......@@.@.
@..@@...@.@@.@...@..
..@@.@@@....@@@@@@@@
@....@..@.@@.@.@.@.@
@.@@...@..@@...@...@
@@@@@@..@.@@.@...@..
@@@.@@.@..@..@@.@..@
@......@@.@@...@.@..
.@.@.@..@@...@.@.@.@
....@@@....@..@.....
2
1 11 0
19 10 1

0 19 0
12 7 1
