width 20
height 20
@@@@.@..@......@@@..
@@@@.@@..@@@.@.@.@.@
@@@..@.@......@....@
@@.@.....@.@.@@@@.@@
@....@.@@.@.@......@
.@.@@.@@......@.@.@@
....@...@.@.@..@@@@@
@@.@@.@....@@@@@@.@@
.......@@.@..@.@...@
@.@.@@.@@@.@....@.@.
.@@@.........@@.@.@.
..@@@@.@@.@.@@@@....
.@.@@@.@.@...@@.@.@.
....@.....@.@@...@..
.@.@@@@.@.@@..@.@.@.
@...@@.@@...@.......
@@.@.@....@...@.@.@@
@......@.@@.@@@@@@@@
..@@.@.@@.....@@@@@@
@..@..@@..@@.@@@@@@@
2
5 10 0
9 15 1

16 4 0
19 0 1
