width 20
height 20
@.....@......@@...@@
.@@.@..@@.@.@@@.@..@
..@.@.@....@@@@@@.@.
.@.@@..@.@@.@.@@....
......@..@.....@@.@.
@.@.@...@.@.@.@..@..
@@.@.@@......@@@..@.
@@...@.@@.@.@.@.@...
@..@.......@......@.
@.@@@.@.@.@.@.@.@@@.
...@@@..@.@....@@@@.
@.@.@.@@.@..@.@@@@@@
..........@..@@@@@@@
.@.@.@.@.@@.@@@@@@@@
..@@@..@.....@@@@@@@
@..@..@@@@.@@@@@@@@@
..@.@..@@@@@@@@@@@@@
@...@.@@@@@@@@@@@@@@
..@.@@@@@@@@@@@@@@@@
@.@@@@@@@@@@@@@@@@@@
2
19 6 0
5 3 1

8 6 0
5 0 1
