width 20
height 20
.@.@@.@.@.@...@@.@.@
...........@@.......
@.@.@.@.@@.@@@.@@@.@
@..@.@.@....@.@@.@..
@@......@.@@.....@.@
@@.@.@.@.....@.@....
@.@.@@..@@@@..@@@.@@
.......@@@@..@@@....
.@@.@.@@@@..@@@@@@.@
@@@@.@.@@.@..@@@@@.@
............@@@@@@@@
.@.@.@.@.@.@.@@@@@@@
@.@.@.@@@......@@@@@
....@.@@.@@.@.@@@@@@
.@@....@..@..@@@@@@@
@@@@@.@.@...@.@@@@@@
@@@@......@......@@@
@@@@@@@.@..@@.@.@@@@
@@@@@@@@..@....@@@@@
@@@@@@@@@.@@@.@@@@@@
2
0 13 0
4 11 1

11 16 0
2 10 1
