width 20
height 20
....@..@..@@@@@@@@@@
@.@@..@.@.@@@@@@@@@@
.....@.....@@@@@@@@@
.@.@..@.@@@@@@@@@@@@
@.@.@....@@@@@@@@@@.
......@.@.@@@@@@@@..
@.@@.@@.@.@@@@@@@@@.
....@@.....@@@@@@@@.
@.@...@.@@@@@@@@@@..
...@@.@.@@@@@@@@@.@.
@.@@@@@.@@@@@@@@@...
....@.@@.@@@@@@@@.@.
@@.@......@@@@@@@@..
.....@@@.@.@.@.@@.@.
.@@@.@..............
....@@@.@.@@.@@.@.@.
.@.@@@@.@...@..@...@
@...@@@@@.@..@.@@.@.
.@@..@@@@..@....@.@.
....@@@@..@..@.@@...
2
9 17 0
14 13 1

0 13 0
17 19 1
