width 20
height 20
.@@@......@...@@@@@.
.....@.@@..@@.@@@@..
.@@.@...@.@@......@.
.@@@.@.@.@.@.@.@@@@.
@@@...........@@....
@@@@@.@@.@@.@....@@.
@.@.@.@@@@@@..@@.@..
.....@@@.@@.@@..@..@
@.@.@.@........@.@.@
@..@....@@@.@@......
..@.@@@....@@..@.@@.
@...@...@.@@..@...@.
@@@.@.@@@@...@.@.@..
@@.....@@..@@.....@.
@@@.@.@@@@...@@@.@@@
@@@@..@.@.@@@..@....
.@@@@.........@..@.@
..@@..@.@.@.@..@@..@
.@...@...@@@..@@@@..
...@.@@.@@@@@..@@@.@
2
3 7 0
19 9 1

4 1 0
13 2 1
