width 20
height 20
@@@@@@.......@.@.@.@
@@@@@@@.@@.@........
@@@@@@....@.@.@@.@.@
@@@@@@.@.@......@..@
@@@@@.@@..@.@.@@.@..
@@@.@.@.@.@@..@....@
@@.......@@@.@.@.@..
@@@.@.@.@.@.@@.@..@.
@.@..@...........@@@
....@@@.@.@.@.@@.@@@
@@@...@@@.@@.@..@.@@
@@@@.@@@.@.@.@.@...@
@@@...@.........@.@.
@@.@.@@@.@.@@@@.....
@.....@...@@.@.@@.@.
@@.@.@.@@.@........@
@@@..@.@.@.@.@.@@@..
...@..........@@@@@.
.@...@.@.@.@.@@@@@@.
..@.@@@...@@.@@@@@@@
2
0 18 0
14 1 1

1 14 0
17 14 1
