width 20
height 20
.....@.@.....@.@....
.@@@.@.@.@.@....@.@.
@@@@.....@.@.@.@.@..
.@@..@@.@.@...@...@.
.@.@.@.@@...@@@@.@..
.@.....@@.@...@...@.
...@.@...@..@@..@...
@@@.@.@.@@@..@@.@@@.
.........@..@.....@.
.@.@.@@.@@@.@.@.@..@
..@@@..@@@@.@..@..@@
.@.@@.@.@@.@.@..@...
..............@.@.@.
@@.@.@.@@@.@.@.@@@..
@@@...@@@@@........@
@@..@@@@@@.@.@.@.@..
@@@...@.......@@..@@
@@@@.@@@.@.@.@@@@@@@
@@@@.@@...@..@@@@@@@
@@@@.@@@.@@@..@@@@@@
2
19 15 0
18 2 1

11 4 0
16 3 1
