width 20
height 20
...........@......@@
.@.@@@.@@@.@@@@@@..@
..@.@.@@.@@..@@...@@
.@..........@.@@.@@@
...@.@@.@.@.......@@
.@..@....@@@.@.@.@..
..@@@.@.@@@@..@....@
@.@.@@.@@@@..@@@.@.@
..@.....@..@@.@.@...
@.@@.@.@@@.......@.@
@@@@@......@.@.@....
.@@@.@.@.@@.@@@..@@@
..@...@.@....@.@...@
@.@.@...@@.@.....@@.
...@..@.@@..@@.@.@@.
@.@.@.@....@.@..@...
.......@.@.@...@.@@.
.@.@.@.@..@.@@......
..@@@...@.@..@.@.@.@
.@@@@@.@@...@@@...@@
2
7 5 0
1 12 1

1 7 0
18 12 1
