width 20
height 20
@@.@.@.@.@.@.@.....@
@.............@.@.@.
@@@.@@.@@@.@@@@@....
@.@@...@......@@.@@.
.....@.@@.@@.@@.@.@.
.@.@..@....@@.......
@...@.@@.@@@..@.@@.@
.@.@..@@..@@@@....@@
.@@..@@@@..@..@.@.@.
.@@.@.@@@.@.@....@..
...@...@......@.@@.@
@.@.@.@..@.@@.@.@...
........@.@@.@@.@.@.
@.@.@.@........@...@
...@@@@@.@.@.@...@..
@.@.@@@.@...@..@.@.@
..@..@..@@.@.@..@...
@.@.@.@.@@@@..@@.@.@
.........@.@.@.@....
@.@.@.@.@........@@.
2
13 5 0
19 18 1

1 18 0
10 3 1
