width 20
height 20
@@@@@@@@..@.@.@...@@
@@@@@.@.@......@.@.@
@@@@.....@@.@@......
@.@..@@.@.@@@.@@@.@.
..@@.@........@.@@@.
.@@...@.@.@.@.......
.@..@..@...@@@.@.@@.
..@.@.@@@.@.@.@@@...
@....@@@@@........@.
..@.@.@@@@@.@.@.@..@
@.@....@@@@@@..@.@..
...@.@@@@@@@@.@@.@@@
@.@.@@@@@.@@........
@...@@@.....@@.@@.@@
.@@..@..@.@..@...@..
....@.@.@@..@..@..@.
.@@.@.@.@@.@@.@..@..
.@........@.@@.@.@.@
..@.@.@.@.@.........
.@@@..@@...@@@.@.@.@
2
1 18 0
14 15 1

16 15 0
19 5 1
