width 20
height 20
@@@..@.@.@..........
@@.@...@...@@.@.@@@.
@....@...@.@@@.@.@.@
@@.@..@.@.@........@
@@@..@.@@.@.@@.@.@.@
@@@@........@...@@..
@@@@.@.@.@.@.@@@@@.@
@@@@.@..@@@.........
@@@@.@@@@@@.@.@.@@.@
@@..@@@@@..@@@..@...
@.@.@@@@@.@.@.@..@.@
@....@@@@.......@.@.
@@.@.@.@.@@.@.@.....
@@@........@@@@.@@.@
@@..@@.@.@.@@@@@@...
@.@.@.@.@.@.@@..@@.@
...............@.@..
.@.@.@.@.@.@.@.@...@
.@@.@.@.@.@@@....@.@
..........@...@@..@@
2
9 3 0
17 11 1

9 1 0
4 0 1
