width 20
height 20
@@..@@..@@@@@@@.@@@.
@..@...@.@.@@@......
.@...@......@@@@@@.@
...@..@.@@@@@@@@....
.@@.@.@@.@@@@@@..@.@
.@.........@@@..@.@@
..@.@@@.@.@.@.@.....
@.@..@@@.......@@.@.
.@.@.@..@.@.@@..@..@
......@...@@.@@.@@..
.@.@.@..@.@..@.@.@.@
..@@.@@.@@..@.......
@.@.@....@.@@.@@.@.@
....@@@@@.....@..@..
@.@.@.@.@.@.@.@.@..@
@.@........@...@.@..
...@@.@.@.@@@.@....@
.@.@...@@@.@@@@@.@..
@@@@@.@.@...@.@@.@@@
@@@...@...@........@
2
11 13 0
14 11 1

6 1 0
5 12 1
