width 20
height 20
.@.@@@..@...@.@.@.@.
.@.@...@.@@...@...@.
.....@......@@.@@...
.@.@@..@.@.@.@.@.@.@
.@.@@@.@@...........
..@@@..@@@@@.@.@.@@.
.@..@.@.@..@@@@@@..@
...@.@@...@.@@.@.@.@
@@......@...@.......
@..@.@@..@@..@.@.@.@
.@.@@@@.@.@.@...@.@@
..@@@@.@.....@.@@..@
@..@...@@.@.@@.@.@..
.@.@@@.@@.@@@....@.@
.............@.@....
.@@.@.@.@@@.@@@@.@.@
...@@@..@@@.@...@..@
@.@.@.@@.@.@.@.@.@.@
....................
@.@.@.@.@.@@.@.@.@.@
2
14 3 0
16 4 1

14 14 0
0 4 1
