width 20
height 20
@@@@@@@@@@@.@@@.....
@@@@@@@@@....@@.@@.@
@@@@@@@@.@@.@@@@...@
@@@@@@@.......@.@@.@
@@@@@@@@.@@.@@......
@@@@@@@@@@..@.@@.@.@
@@@@@@.@.@@.......@.
...@@..@...@.@.@.@..
@@.@.@..@.@..@@.@.@.
.......@..@@........
@@.@.@..@....@.@@@.@
@@.@@.@@@.@@..@.....
@...@..@.@@..@.@.@.@
.@.@.@.....@....@@..
.......@.@@@.@@.@..@
@.@.@@@.....@@..@@@.
...@..@@.@.@..@.....
@.@@.@.@.@@@@...@.@.
.......@.@.@@.@.@@..
@.@.@.@.......@@@@@.
2
6 10 0
7 19 1

13 11 0
4 14 1
