width 20
height 20
.......@@@@.@.@@@@@@
.@.@@@.@.@......@@@@
..@@......@.@.@@@@@@
.@.@@.@.@...@@..@@@@
...@@..@@@@.@.@...@@
.@...@@@@@.....@.@.@
@@.@@..@@..@@.@@...@
.....@.@@@.@.....@..
.@.@....@.@..@.@..@.
..@@@.@@...@..@@@@@@
@@.@.....@.@@..@@@@@
....@.@@..@...@@@@@@
.@@.@@...@.@@@@@@@@@
.@.....@.@.@@@@@@@@@
@@@.@.@@@...@@@@@@@@
@@@..@@@.@.@@@.@@@@@
@@@@............@@@@
@@@..@.@.@.@.@.@@@@@
.@.@.@.@@..@.@.@@@@@
......@@@@.@@..@@@@@
2
12 18 0
0 18 1

12 5 0
1 2 1
