width 20
height 20
@@@@@@.....@........
@@@@@@.@.@..@.@@@.@.
@@@@@@.@@.@..@@.@@..
@@@@.@.@@...@.@..@@.
@@@@...@@@@.....@...
@@@.@.@.@.@.@.@.@.@.
@@@........@@@.@@..@
@@@@.@@.@.@.@...@.@@
@@@@@@@@......@....@
@@@@@@@@@.@.@.@@.@@@
@@@@@@@@@@...@@@@@@@
@@@@@@@@@@@.@@@@@@@@
@@@@@@@@@@@@@@@@@@@@
@@@@@@@@@@@@@@@@@@@@
@@@@@@@@@@@@@@@@@@@@
@@@@@@@@@@@@@@@@@@@@
@@@@@@@@@@@@@@@@@@@@
@@@@@@@@@@@@@@@@@@@@
@@@@@@@@@@@@@@@@@@@@
@@@@@@@@@@@@@@@@@@@@
2
8 0 0
10 10 1

12 0 0
17 4 1
