width 20
height 20
......@..@.......@.@
.@@@@.@@...@.@.@....
..@...@..@.@.@@..@@.
@..@.@@.@.@@...@...@
@@@.......@@@.@@@@..
@...@.@.@..@.@...@@.
.@.@@.@.@.@...@.@.@.
...@.@.@@...@......@
@@.....@.@.@.@.@@@..
@@@@.@....@.....@.@@
@@@@@..@.@@@.@@@..@@
@@@@@@..@.@....@.@..
@@@@@@.@....@.@@...@
@@.@....@.@.@@@..@..
.....@.@.@...@.@@.@.
@.@.@@@....@........
@@@@@@@@.@.@.@.@.@@.
@@@@@@@@@.@.@..@@...
@@@@@@@@......@@@@@.
@@@@@@@@@@.@@...@...
2
17 10 0
9 9 1

10 15 0
16 15 1
