width 20
height 20
........@@@.........
..@.................
......@.............
...@.@..@...@..@....
...@.....@..........
..@...@............@
.........@..@.....@@
.....@..........@.@@
..@...@............@
.........@.........@
.@...@......@...@.@@
..................@.
...@...@............
....@..........@....
.........@..@.@.....
....................
.......@............
...@......@.@...@...
.......@............
....................
6
16 3 0
16 19 0
2 19 0
5 1 0
4 15 0
14 3 0

7 2 0
19 2 0
16 0 0
0 11 0
8 16 0
3 19 0
