width 20
height 20
@@@@................
......@.............
....................
...@..@.@......@....
....@....@.@........
..............@.....
..@........@........
@.......@...@.......
......@.............
...............@....
@.....@..@.......@.@
@.@..@..............
..........@.........
.....@...@....@.....
...@................
....................
......@..........@..
....................
..@............@....
...................@
6
17 18 0
14 1 0
12 18 0
16 6 0
7 8 0
11 13 0

8 19 0
15 16 0
11 15 0
0 19 0
18 7 0
0 2 0
