width 20
height 20
@@@@@....@.@.......@
@@@@@@@..@.@....@...
@.@@@@@.......@...@.
.........@..........
.....@......@.......
........@.@.....@...
................@...
.....@..............
....................
..@.@........@......
........@.....@.....
..................@@
..................@@
........@..@......@@
....@.@...@.....@..@
@..................@
@..........@.@.....@
@.......@.@.........
@.......@...........
....................
6
4 8 0
9 9 0
7 8 0
13 15 0
17 2 0
2 12 0

15 18 0
7 12 0
14 16 0
0 6 0
2 6 0
13 5 0
