width 20
height 20
@@...............@@@
@................@@@
..........@.........
...........@........
...@....@....@..@...
.......@.@..........
..........@....@...@
...@..@....@..@.....
.@..@..@.....@.@....
........@...........
............@...@...
....@...@..@........
..............@.....
..@........@........
@@...............@..
@@.@................
@@....@.....@....@..
........@.....@.....
....@....@......@...
....................
6
11 9 0
19 7 0
15 3 0
5 15 0
12 18 0
9 0 0

9 19 0
18 10 0
10 0 0
18 5 0
11 17 0
9 1 0
