width 20
height 20
.......@........@...
....................
....................
...............@....
...@.........@......
....@.....@...@.....
........@...........
..@..@.....@........
....................
.....@..............
.......@............
............@.......
....@......@........
...............@..@@
.......@..........@@
.@@.....@........@@@
......@...........@@
.....@.............@
@..................@
...........@@......@
6
3 13 0
4 13 0
16 14 0
12 0 0
14 12 0
16 18 0

7 17 0
1 5 0
2 8 0
12 6 0
3 2 0
19 10 0
