width 20
height 20
@@@@@...@...........
@@@@@..@............
@@@.................
....................
..........@.........
.....@.@.....@......
.@@...@.............
@@@....@............
@@@@................
@@.........@.....@..
@@...........@......
@@..............@...
@......@............
...........@........
....................
....@..@.@..@..@....
....@@..............
....@...............
....................
....................
6
18 13 0
19 8 0
12 2 0
13 18 0
6 12 0
18 19 0

17 8 0
19 1 0
13 0 0
12 5 0
19 2 0
18 13 0
