width 20
height 20
....................
....@.......@....@..
...@...@............
..@.................
....@.......@.......
.............@...@@@
....@.......@..@.@@@
.@.................@
........@.@.@.@.....
....................
...@@...............
........@.........@.
@...................
@...@..@.@.@...@....
......@.............
..@......@.....@....
...@..@.............
.........@..@.......
...............@....
.........@..........
6
2 17 0
12 5 0
17 11 0
17 7 0
7 6 0
2 10 0

10 14 0
19 8 0
18 0 0
3 0 0
19 11 0
3 6 0
