width 20
height 20
....................
...............@....
....................
.........@@..@......
..@....@.@@.........
...@................
..............@.....
.......@.....@......
.@.......@..@.@.....
....................
.........@..........
..@.................
..........@......@..
..@...@....@.....@@@
...............@@@@@
.........@....@@@@@@
...@.@........@@@@@@
@.............@@@@@@
....@@......@..@@@@@
....@@..@........@@@
6
7 10 0
5 1 0
10 18 0
7 8 0
4 15 0
3 15 0

3 19 0
15 19 0
19 1 0
10 10 0
0 2 0
9 11 0
