width 20
height 20
@@@@@@@@@@@@........
@@@@@@.@@@@@........
@@@......@@@...@....
.........@..........
....................
..............@.....
..@.@....@.........@
...................@
..........@....@....
....................
.....@..............
...........@..@.....
.............@......
..@.@.............@.
..........@.....@...
................@...
............@.......
.........@...@......
..........@.........
.............@......
6
13 11 0
8 13 0
16 11 0
6 19 0
19 1 0
15 16 0

15 12 0
19 14 0
17 19 0
6 9 0
14 8 0
15 16 0
