width 20
height 20
@@@.................
@@.................@
@@..@..@.........@@@
..........@......@@@
....@......@.@......
....................
.............@.@....
....@...............
....................
........@....@.@....
................@...
...........@........
@@@@..@.............
@@@..........@..@...
@@.....@............
@@..........@.......
@@............@.....
@@..................
.......@...@........
.........@..........
6
13 14 0
18 12 0
7 17 0
7 19 0
2 5 0
12 7 0

5 12 0
3 1 0
5 19 0
2 5 0
12 4 0
12 7 0
