width 20
height 20
...................@
............@......@
...................@
...@.@.............@
........@.@.........
............@.@....@
...@................
......@........@....
.....@..............
......@..@..........
............@...@...
..........@.........
@...@@@@....@.......
@@@@@@@@......@.....
@@@@@@@@@..........@
@@@@@@@@@@@.........
@@@@@@@@.........@..
@@@@@@@@...@.@.@....
@@@@@@@@............
@@@@@@@@............
6
4 9 0
9 10 0
1 10 0
15 11 0
13 18 0
2 11 0

15 6 0
18 0 0
1 7 0
17 1 0
10 5 0
2 12 0
