width 20
height 20
.....@.....@........
....@......@........
.........@.@........
....@.........@.@...
.......@............
..@....@............
.@....@.@...........
.........@..........
......@......@......
....................
...@..@.........@...
..@..@.........@...@
...........@.@.....@
.....@..@...........
......@.....@....@..
....................
@..@.@......@..@....
...........@.@......
....................
....................
6
8 11 0
10 3 0
13 10 0
9 6 0
19 16 0
0 19 0

9 15 0
8 18 0
6 12 0
11 7 0
16 17 0
0 18 0
