width 20
height 20
@@@@...........@....
.@@........@...@....
.......@............
...@...........@....
.....@..@....@......
..................@.
.........@..........
...@......@.........
....@...............
.......@.........@..
.@.......@...@..@...
@................@..
@...................
@......@............
@.........@.........
.....@..............
....................
.......@......@.....
..@........@...@....
......@@@...........
6
5 6 0
17 6 0
4 0 0
16 11 0
4 3 0
15 9 0

14 13 0
1 8 0
12 11 0
1 4 0
11 14 0
15 10 0
