width 20
height 20
....@..@......@@..@@
..@................@
...@..............@@
.......@.@......@@@@
.....@............@@
...@.....@..........
.@....@.......@..@..
....................
....................
..@...@.@....@......
..........@....@....
.....@.@............
.............@......
...............@....
...@........@.......
.@.......@...@......
....@.@.............
...@......@..@......
............@.......
....................
6
15 19 0
8 11 0
11 18 0
11 10 0
15 8 0
15 18 0

8 0 0
10 3 0
18 8 0
15 19 0
12 12 0
5 15 0
