width 20
height 20
@...@@@@............
....@@@@............
.....@@@........@...
.....@..............
...@.@..............
............@.......
....@.@............@
@..................@
..@....@........@..@
....@...@....@......
.......@...@@.......
.@..............@...
....@...@...@.......
......@.............
...@................
........@......@....
.....@......@...@...
...@..@...@.........
..@.................
....................
6
7 9 0
7 11 0
9 18 0
0 12 0
9 4 0
11 6 0

1 9 0
8 10 0
19 0 0
9 1 0
2 0 0
1 18 0
