width 20
height 20
@................@@.
.........@..........
.....@............@@
..@....@..@.......@@
............@.......
.....@..............
.......@......@.@...
.............@......
............@.....@.
....@..@............
..............@.....
....................
.....@..............
..........@.........
...@........@...@...
..@.................
....@@@.............
........@.@.........
....................
..........@........@
6
8 9 0
2 7 0
5 17 0
1 11 0
17 3 0
18 15 0

4 15 0
13 2 0
17 11 0
1 11 0
1 6 0
19 16 0
