width 20
height 20
......@@@@@@@@......
......@@............
..@...@@............
...........@........
................@...
.........@......@...
...............@....
...@....@........@..
.................@..
..........@.........
.....@...........@..
..........@..@..@...
.........@..........
......@..........@..
...........@....@...
....@..@....@.......
........@....@......
.........@@..@@..@@@
.....@..@@@..@@..@@@
.........@.......@@@
6
8 3 0
8 14 0
12 6 0
13 8 0
10 8 0
11 2 0

4 10 0
6 15 0
10 8 0
1 1 0
17 5 0
11 2 0
