width 20
height 20
....................
.........@..........
.@....@.@...........
....................
..........@...@.....
.@.....@......@..@..
.@..................
.............@......
.........@...@......
.....@.........@....
..................@.
....................
@........@.@...@....
.@..................
.....@...@.....@....
..............@..@.@
...................@
........@........@..
...@@.......@@......
....@...........@...
6
15 8 0
17 13 0
5 0 0
3 3 0
10 10 0
13 16 0

14 0 0
1 18 0
11 14 0
9 16 0
0 0 0
1 1 0
