width 20
height 20
@@@@....@@...@.....@
@@@..@@@...@...@@.@@
@@..@@@@@.@.@.@.@...
@@@....@@@......@.@.
@@@@.@@.@@@.@.@.@@..
@@@@.....@.@..@..@.@
@@@..@@.@....@..@.@.
@@@@.@@@.@.@..@.....
@@@...@.....@@@@.@@.
@@.@.@.@.@.@..@.@...
@@.....@.@.@@...@@.@
@@@@.@..@@@...@.@...
@@@...@@.@.@.@.@.@.@
@..@.@.@............
..@......@@@.@@.@.@.
@.@.@@@.@..@...@@@..
....@.....@.@.@.@.@.
@.@..@.@@....@......
.@.@..@@@@.@.@@.@.@.
.....@@@@...@@...@@.
5
4 12 0
14 15 0
10 1 1
10 0 1
12 11 2

19 2 0
12 0 0
2 19 1
15 5 1
12 11 2
