width 20
height 20
...@.....@.@@..@...@
@@...@@@@.....@.@@.@
.@@.@@@@..@.@.......
....@@@@@..@..@.@.@.
.@@@.@@@@.@..@@.@@..
..@@.@@@@@.@.@.@.@@.
.@@@.@@@@..........@
......@@@@.@.@@.@.@.
@.@.@.@@@.@.@@@@....
@@@@...@@...@.@.@@@.
@@@@@.@...@.........
@@@@@..@@..@@.@.@@@.
@@@@@.@.@.@@.@.@@.@@
@@@@................
@@@@@.@.@.@.@@.@.@@.
@@@@@..@...@..@@@...
@@@@@@@@@@.@.@.@.@.@
@@@@@@@@@@@.........
@@@@@@@@@@@@.@.@.@@.
@@@@@@@@@@@@@..@@...
5
18 17 0
9 1 0
12 12 1
9 4 1
12 17 2

12 13 0
13 10 0
0 0 1
10 11 1
14 18 2
