width 20
height 20
.@@@@....@.@@@@@@@@@
.@@@@@.@....@@@@@@@@
.@@@@@@..@@@@@@@@@@@
...@@@.@..@...@.@@.@
.@@.@....@.@.@.....@
.....@.@@......@@@@@
.@.@@@..@.@.@@..@...
..@@...@@@@@@@.@.@.@
.@.@@.@.@.@.@.......
.............@.@@.@@
@.@@.@@@.@@@....@@@@
....@@..@@@..@.@@@@@
@.@@...@@@.@..@@@@@@
@@...@.......@@@@@@@
@@@.@.@.@.@@@@@@@@@@
.@..@..@@@@@@@@@@@@@
..@..@..@.@@@@@@@@@@
@.@.@.@...@@@@@@@@@@
@.......@@@@@@@@@@@@
@@.@.@@.@@@@@@@@@@@@
5
7 17 0
2 3 0
3 16 1
4 13 1
7 13 2

0 0 0
6 6 0
12 12 1
12 10 1
3 17 2
