width 20
height 20
@@@@@@@@@@@.@....@@@
@@@@@@@@@....@.@..@@
@@@@@@@@..@.@..@.@.@
@@@@@@@@@..@.@@.....
@@@@@@@@@.@@.@..@.@.
@@@@..@@@.@@...@.@..
@....@.@.....@.@...@
@@.@....@.@@..@..@..
@@@@@.@@.@.@.@@@@@.@
@@..............@..@
@.@@@.@@.@.@.@.@@@@@
.......@.@@.@..@@@@@
.@@.@.@.@@@..@.@@@@@
@.@..@@..@@.@...@@@@
...@@@..@.@.@@@..@@@
@.@.@.@.........@@.@
@.......@@.@.@@.....
..@.@.@...@@@@@@@.@.
@..@...@.@@@@@@@@.@@
..@@@.@...@@@@@@..@@
5
8 6 0
0 17 0
1 16 1
10 10 1
2 7 2

10 6 0
17 4 0
18 8 1
16 16 1
17 9 2
