width 20
height 20
.@.@.@..@@@@@@@.@@@@
...@..@..@@@.....@@.
.@.@@.@.@.@..@@.@...
..@........@...@..@.
.@.@.@.@@.@.@.@@@.@.
.@....@.....@......@
...@.@@@.@.@.@.@@.@.
@@..@.@...@....@.@..
@..@...@.@@@.@.....@
@@@..@@...@.@.@.@@.@
.@@.@..@.@@...@@.@..
.@...@......@....@.@
...@...@@.@.@@.@.@.@
.@@.@.@....@@@@.....
.@@..@@@@@.....@@.@@
....@@@@...@.@@...@@
.@.@@@@@@.@..@@.@..@
@@@@@@@@@@@@.@...@@.
@@@@@@@@@@@@@.@.@.@.
@@@@@@@@@@@@........
5
11 14 0
17 3 0
5 3 1
12 2 1
14 3 2

8 11 0
14 8 0
1 15 1
2 12 1
1 1 2
