width 20
height 20
@@@@@@@.......@..@@@
@@@@@@@.@.@.@@..@.@@
@@@@@@..@@@@@@@....@
@@@@.@.@@.@.@@@.@.@.
@............@..@...
.@.@.@.@.@.@..@..@@.
....@..@@@@@@...@@..
@@.@.@...@.@.@@.@.@.
.@@@.@@.@....@@@....
..@....@..@@.....@@@
.@@.@@..@...@.@.@@@@
.@.@.@.@..@@@@....@@
.........@@@@@@.@@@@
@@.@.@.@@.@@@@@..@@@
...@@.......@@@.@@@@
.@..@@.@.@.@.@.@@@@@
@..@.@@@@......@...@
@@....@@@@.@.@.@.@..
@@.@.@@@@.@.@@....@.
@@@...@........@.@..
5
4 17 0
16 19 0
5 6 1
7 2 1
6 9 2

1 12 0
7 7 0
16 5 1
19 4 1
9 0 2
