width 20
height 20
..........@.@@.@.@@@
@@.@.@.@.@.......@@@
@@..@@@...@.@.@@...@
@@.@.@.@.@@@..@..@..
@.@@......@@@..@@.@.
.....@.@.@@@.@.@....
@@.@.@.@.@....@@@.@@
@@..@@..@@@.@.@@....
@@.@@..@.@@@.....@.@
@.@@.@.@..@.@.@.@@@.
........@.....@.....
@.@.@@@...@.@..@@.@.
@@@@@.@.@@@@.@.@@@..
@.@.@.@.@@......@..@
.......@@..@.@.@@@..
@.@.@@.@@@..@.@@@..@
..@@@.@.@.@....@.@..
@...........@.@....@
..@.@.@@.@.@...@.@..
@..@...@..@@@.@@@@.@
5
18 19 0
16 8 0
18 2 1
4 6 1
4 19 2

7 7 0
14 1 0
3 13 1
16 1 1
16 17 2
