width 20
height 20
...@....@@@@@@@@@@@@
.@.@.@@..@@@@@@@@@@@
@@.....@.@@@@@@.@@@@
@.@@.@.@@@@@@@...@@@
.....@@@@@@@@@@.@.@@
@.@.@.@@@@@@@@.....@
@@....@@.@@@@@@.@.@.
@.@@.@.@..@.@.@..@..
..@@.....@......@..@
@..@.@@@...@.@.@..@@
@@.@@..@.@@@@@...@@@
@....@..@@....@.@@@@
@@.@@.@.@@@@@...@@@@
@.............@.@@@@
.@.@.@.@@.@.@.@@.@@@
....@....@..@@.@...@
@.@.@.@@.@@......@@@
@@..@...@@@.@.@.@.@@
@.@..@.@@@@.@@......
....@@@@@@@@@@@.@.@@
5
18 7 0
19 18 0
14 16 1
11 13 1
15 2 2

15 8 0
13 8 0
14 16 1
4 8 1
14 3 2
