width 20
height 20
....@@.@.@.@........
@.@.........@@.@.@.@
@@..@.@.@.@..@..@...
@@@.@.@@.@.@...@@@.@
@@@@@@.@.....@..@@@@
@@@@@....@@.@@.@.@.@
@@@@@@@@.@@@........
@@@@@@@....@@.@.@@.@
@@@@@@..@.@.@@.@@.@.
@@@@@.@.@.@.........
@@@@....@@@.@.@.@.@.
@@@.@@.@.@@..@@@@@@.
@@..........@@@.@.@.
..@.@.@@.@@........@
@....@..@...@.@.@.@.
..@.@@@..@@@...@....
@..@....@@.@@.@@@@.@
..@..@.@.@.@@..@.@..
@...@......@..@@...@
..@@@@.@.@..@..@@@.@
5
8 4 0
13 0 0
8 7 1
11 14 1
3 11 2

0 0 0
13 18 0
11 5 1
5 18 1
6 11 2
