width 20
height 20
..@@@.@.@..@.....@..
.@.@.....@.@.@.@@.@.
.@...@.@@@...@.@....
...@..@@.@.@..@.@.@.
@.@@.@.@...@@......@
..@......@.@.@.@.@..
@..@.@@@.@@.....@@@.
.@@.@.@.@.@@.@.@.@@.
..............@@.@@.
.@.@.@.@@.@.@@.@.@@@
..@...@.@@........@@
.@@.@@..@.@.@.@.@.@@
@@@.@.@......@...@@@
@@@@....@@.@@@.@@@@@
@@@.@.@...@@@@...@@@
.@....@@@.@@@@.@@@@@
..@.@....@@@@@@@@@@@
@....@.@..@@@@@@@@@@
..@.@@@..@@@@@@@@@@@
@..@@@@@..@@@@@@@@@@
5
6 16 0
7 14 0
8 16 1
17 3 1
0 1 2

8 4 0
6 5 0
5 5 1
11 10 1
0 16 2
