width 20
height 20
...@@@@@@.@@@@@@@@@@
@@.@@@@@..@@@@@@@@@@
@@..@@@.@.@@@@@@@@@@
...@.@@....@@@@@@@@@
.@......@.@@@@@@@@@@
@@@.@.@..@@@@@@@@@@@
@@...@..@@@@@@@@@@@@
..@.@@@..@@@@@@@@@@@
@..@@...@.@@@@@@@@@@
@.@...@....@@@@@@@@@
....@..@@.@@@@@@@@@@
@.@.@@@..@@@@@@@@@@@
@..@....@@@.@@@@@@@@
@@...@.@.@..@.@@@@@@
@..@@@....@.@.@@@@@@
@@@....@@......@@.@@
@@@@.@...@.@@@.@...@
.@.@..@@..@.....@.@@
.....@...@..@.@.....
.@.@@..@..@@..@.@.@.
5
19 19 0
8 3 0
0 7 1
17 15 1
13 17 2

11 17 0
4 12 0
13 14 1
7 8 1
5 10 2
