width 20
height 20
@@@@@@.@..@@@...@@@@
@@@@@...@...@@@..@..
@@.@.@.@.@@.@...@@@.
@.............@.@@..
@@.@.@@.@.@.@@....@.
@...@.@..@@@@.@.@...
@.@.@..@.@@@.....@.@
.@@@..@.@.@.@.@.@...
...@@.@........@.@@.
@.@.....@.@.@.@@.@.@
....@.@..@...@@.....
.@@..@@@.@.@.@@@.@.@
.@..@.@.@.@.@.@.@@..
..@.........@......@
@..@.@.@.@@...@@.@.@
..@@@@@@..@@@...@...
@....@@..@@@@@.@.@.@
..@.@@@@.@@@@@@@....
.@..@@@@@@@@@@@.@.@.
..@@@@@@@@@@@@.....@
5
15 13 0
19 8 0
17 13 1
3 16 1
5 10 2

9 3 0
18 7 0
7 16 1
12 11 1
2 2 2
