width 20
height 20
@@@..@.@.@..@......@
@@@.@......@.@@@.@..
@....@@.@@@...@@@..@
@@.@.....@.@@.@@.@.@
@.@.@@.@............
....@@@@@@.@.@.@.@.@
.@@.@.@@@@..@@.@.@..
.@.......@@.@...@.@.
@.@@@.@@...@..@@....
...@....@.@@@@@@.@@.
@.@.@.@@.@.@.@.@@@@.
....................
@.@@.@.@@@.@.@@.@.@@
....@.@@.@..@@...@.@
@.@......@.@@.@.@..@
.@..@@.@..@@...@..@@
...@@.@..@..@.@.@..@
@.@.....@@@.......@@
@@..@.@.....@.@.@..@
@@@..@@@.@.@@..@..@@
5
14 0 0
10 1 0
14 6 1
17 12 1
7 7 2

3 19 0
5 11 0
3 17 1
4 0 1
4 9 2
