width 20
height 20
...@@.@.@.@@@....@@.
@.@.@.@....@.@.@@@..
........@.@.......@.
@.@.@@@@.@.@.@.@@...
.@..@@........@@..@.
.@.@.@.@.@@.@.@..@..
........@@@@...@@@@.
@.@.@@.@@@@..@@@@@..
...@@@@@@@.@@@@@@@@.
@.@@.@.@@..@@@@@@.@.
.........@.@@@@@....
@.@.@.@.@...@@@@@@.@
@..@...@@.@..@@@@@@@
..@@@.@...@.@.@@@@@@
@..@@@@@@@.....@.@.@
..@@@.@.@@.@@@......
@.........@@@..@.@@@
@@@.@.@@.@.@.@..@@@@
@@@.@..@.....@.@.@@@
@@@@..@@.@.@........
5
16 16 0
0 10 0
1 16 1
10 17 1
9 11 2

10 15 0
14 14 0
19 10 1
11 13 1
12 4 2
