width 20
height 20
@@@@@.@@..@@.@.@..@@
@@@@.....@@@.....@.@
@@@@@.@@.@@.@@.@....
@@@@@@........@.@.@.
@@@@@.@.@.@.@.@.@@..
.@@@@..@.@@.@......@
..@@@@......@@@.@@.@
@.@.@@@.@.@...@@.@@.
.....@@.@@@@@.....@.
@.@.@.@......@@@@...
@@.....@.@@.@@@@@.@.
@..@.@.@@.......@@@@
..@.@...@.@.@@.@@@@@
.@....@.@@...@.@.@@@
@.@.@@.@.@.@@.@@..@@
..............@..@.@
@@.@.@@@@@.@.@..@...
@@..@..@..@.@@.@.@.@
...@@.@.@........@.@
.@........@@.@.@....
5
19 4 0
9 7 0
7 4 1
4 10 1
12 3 2

12 0 0
15 6 0
19 16 1
10 14 1
0 6 2
