width 20
height 20
..@@.@.@@@@@@@@@.@..
@.@.....@@@@@.@@...@
....@@.@@@@@...@@.@.
.@.@.@..@@@@.@..@...
.@@....@@@@...@...@.
..@@.@..@@@@.@..@@.@
@@....@@.@@..@@....@
@@@.@.....@@.@@@.@..
@@...@.@.@.@@.@.@.@.
@.@@..@.............
@.@..@@.@.@.@@@@.@@.
...@...@...@.....@..
@.@..@..@.@..@.@.@@.
...@@@.@@@@@..@..@..
@.@....@@.@.@..@@..@
....@.@...@.@@@..@..
@.@..@@.@.@.....@@.@
...@.....@..@.@.....
@.@@@.@@..@@.@@.@@@.
@@@@@...@......@....
5
19 11 0
15 8 0
12 6 1
16 6 1
15 3 2

13 1 0
0 2 0
6 5 1
18 5 1
13 19 2
