width 20
height 20
@@@@@@@@@@@@@@@@@@@@
@@@@@@@@@@@@@@@@@@@@
@@@@@@@@@@@@@@@@@@@@
@@@@@@@@@@@@@@@@@@@@
@@@@@@@@@@@@@@@@@@@@
@@@@@@@@@@@@@@@@@@@@
@@@@@@@@.@@@@@@@@@@@
@@@@@@@...@@@@@@@@@@
@@@@@@.@.@@@@@@@@.@@
@@@@@....@@@@@.@...@
@@.@.@.@@.@@@@..@.@.
@..........@@.@.....
.@.@.@.@.@......@.@@
....@.@@.@.@.@.@....
.@.@......@@@.@@@@.@
.@@@@.@.@@..........
..@@@.@@.@@.@@.@.@.@
.@.@.@...@....@@@@@@
.......@@..@.@@@@@@@
@@.@.@.@..@@@@@@@@@@
5
5 9 0
6 19 0
13 14 1
13 11 1
16 13 2

9 18 0
0 18 0
0 16 1
10 17 1
4 17 2
