width 20
height 20
.....@@@@@@@.......@
@.@.@.@@@@@.@@.@@.@@
@@..@..@@@.......@@@
@@@.@@.@@.@.@.@.@@@@
@@@..........@..@@@@
@@@@.@@.@@.@@.@.@@@@
@@@@@..@@@@........@
@@@@@@..@@..@.@.@.@.
@@@@@@@.@.@..@@@....
@@@@@@......@@@@@.@.
@@@@@.@.@@@.@@@@@@@.
@@@@@......@.@.@@...
@@@@@@.@.@...@.@@@.@
@@@@@@@.@..@...@....
@@@@@@....@..@..@@.@
@@@.@..@.@..@..@@@@@
.@...@..@@@.@@..@.@@
...@...@@@@@...@@...
.@..@.@@@@@..@....@.
@..@@@......@..@.@@@
5
15 18 0
10 9 0
2 18 1
8 14 1
3 18 2

17 1 0
1 0 0
8 15 1
5 4 1
8 14 2
