width 20
height 20
@@@@@@@@....@@@@@@@@
.@@.@.@.@.@@.@@@@@@@
.............@@@@@@@
.@.@.@.@.@@.@@.@@@@@
..@@.@@@.@@@.....@@@
@.@.@.@.@.@..@@.@@@@
............@@@.@@@@
.@.@.@.@.@@..@.@.@.@
..@...@@@...@@......
.@@@.@@@@.@....@.@.@
@@@@..@@.@@.@@..@...
.@@.@@.@.@.@@@.@.@.@
.@.....@...@@.@.....
...@.@...@.....@.@.@
@.@@@@@@.@@.@.@@..@@
@......@@..@@@...@.@
@.@@@.@.@.@.@.@@....
.@@@.............@@.
..@.@.@.@@.@.@.@@@..
@......@...@@....@.@
5
1 2 0
10 12 0
18 9 1
11 8 1
3 5 2

8 3 0
5 12 0
13 4 1
3 1 1
9 0 2
