width 20
height 20
@@..@.......@.@@.@.@
@..@@@.@.@@@..@@....
.@...@.@..@.@.@.@@.@
...@@.@.@........@.@
.@........@@.@.@@...
@@@.@@.@.@@@@@...@.@
@@@@....@.@@.@.@....
@@@@@@.@..@...@..@.@
@@@@.@..@..@.@.@..@@
.@@...@.@@.......@@@
.@.@.@.@@..@.@.@.@@@
..........@@@.@.@@@@
@.@.@.@@.@@.@.@.@@@.
...@.@.@@.......@.@.
@@...@.@..@.@.@@....
@..@...@@.@..@@..@@.
@@.@.@..@@.@.@.@.@..
@.@.@@.@.@........@.
...........@@@.@.@.@
@.@@.@.@@.@@@@@@....
5
6 5 0
11 15 0
13 1 1
3 17 1
3 0 2

18 14 0
3 0 0
14 9 1
18 5 1
1 13 2
