width 20
height 20
@.@@.@@.@.....@@@@@@
.........@.@.@@@@@@@
@.@.@.@.@@@@..@@@@@@
...@@..@.@@@.@@@@@@@
@.@..@....@...@@@@@@
....@.@.@@..@@.@@@@@
.@@....@@.@....@.@@@
@@.@@.@.....@@....@@
.......@.@.@@@@@@@..
.@@.@.@...@@@...@..@
@..@...@.@.@.@.@.@..
.@..@.@............@
...@...@.@.@.@.@.@@@
.@...@...@@.@@@@...@
@@@.@@@.@@@......@.@
@@.....@.@@@.@.@.@@@
@@@.@.@@......@.@.@@
@@@@...@.@.@.@.....@
@@@@@.@@.@@@@.@@.@..
@@@@@@@@..........@.
5
3 11 0
6 17 0
2 13 1
3 13 1
7 4 2

11 5 0
18 11 0
19 18 1
19 10 1
0 5 2
