width 20
height 20
.............@@@@@@@
.............@@@@@@@
...............@@@@@
...........@....@...
....................
.@..@..@.@.......@..
...............@....
............@.......
......@.............
...@...........@....
.......@.........@..
....@.@.@......@....
............@..@@...
........@.@.........
......@.............
..@......@...@......
....@.@.............
....@...............
....................
...................@
14
19 3 0
1 1 0
17 9 0
16 7 0
17 4 0
4 18 1
2 8 1
8 14 1
14 3 1
19 17 1
6 17 2
12 13 2
13 19 2
7 12 2

3 15 0
11 17 0
0 19 0
5 19 0
16 18 0
11 1 1
17 19 1
3 5 1
7 18 1
1 1 1
5 17 2
4 1 2
1 8 2
7 14 2
