width 20
height 20
@@@@................
@@@@............@...
@@@@....@..@........
......@......@......
....................
..........@..@......
.......@.......@....
......@......@......
..........@...@.....
@...@...@...........
.............@......
........@...........
...@........@.......
@@..................
@@.....@.....@......
@@......@...........
@@....@.......@.....
@..@.......@...@....
@.......@......@@...
@........@..@.......
14
15 7 0
13 13 0
17 10 0
2 13 0
14 7 0
11 5 1
18 16 1
12 18 1
10 10 1
7 8 1
8 6 2
2 19 2
14 1 2
15 11 2

0 12 0
13 16 0
17 9 0
19 0 0
16 7 0
17 18 1
19 3 1
14 7 1
19 17 1
13 13 1
15 4 2
14 3 2
12 0 2
0 4 2
