width 20
height 20
..@@...@............
....................
.....@...........@..
.@..@....@....@.....
......@........@....
......@.....@.......
....@@@......@.@.@..
..@@@@@..@..........
...@@@@.@...........
....................
..............@.....
..@..............@..
....@...@...........
..@....@.@..........
.............@......
..@......@.@.....@@.
...@........@.......
..@...@.............
................@...
...............@....
14
2 8 0
10 8 0
17 5 0
1 19 0
5 9 0
19 9 1
0 1 1
1 1 1
10 18 1
5 11 1
16 15 2
4 5 2
19 4 2
14 9 2

17 19 0
19 19 0
6 0 0
4 10 0
7 9 0
13 9 1
8 9 1
19 16 1
0 0 1
6 1 1
11 17 2
8 17 2
19 6 2
0 19 2
