width 20
height 20
.......@.....@......
.....@.......@......
..........@....@....
....................
...@..@..@...@......
....................
.@..............@.@.
.............@......
...@.....@........@@
.....@..........@@@@
..........@.........
..@..@.......@..@...
.......@............
.....@...@..........
................@...
......@@...@........
..@.................
....................
....................
@..............@....
14
7 9 0
16 2 0
7 19 0
12 8 0
15 16 0
14 14 1
11 8 1
19 1 1
17 2 1
11 17 1
2 10 2
1 17 2
15 4 2
13 10 2

18 15 0
0 18 0
2 4 0
15 10 0
4 1 0
1 2 1
6 18 1
18 0 1
17 2 1
1 8 1
13 16 2
16 10 2
2 17 2
13 10 2
