width 20
height 20
.........@.....@@...
....................
..@.................
.........@.@........
...................@
......@...@..@.....@
....................
.@....@.............
..........@...@..@..
......@..@..........
....................
.............@......
...@.@@@..@....@....
................@..@
............@.....@@
..............@...@@
...@................
...@................
.............@....@.
.............@......
14
12 6 0
4 1 0
0 7 0
17 13 0
15 6 0
1 19 1
14 3 1
5 2 1
9 16 1
17 14 1
2 9 2
12 5 2
11 16 2
5 3 2

8 17 0
10 14 0
17 14 0
0 3 0
1 17 0
2 1 1
8 7 1
9 11 1
13 0 1
16 16 1
19 8 2
3 19 2
1 1 2
18 19 2
