width 20
height 20
@@..............@@@@
.............@...@@@
@.................@@
.@@.......@..@.....@
...@...............@
...........@...@..@.
.@..................
.........@..@..@....
..............@.....
......@.............
.........@.......@..
.........@........@@
..@.......@..@....@@
.......@..........@@
.......@............
...@...@@..@........
.@..@.......@..@....
........@...........
.........@..........
@@...@.......@@@@.@@
14
11 19 0
4 11 0
6 15 0
0 14 0
12 0 0
8 2 1
15 14 1
4 4 1
2 10 1
9 3 1
18 15 2
17 13 2
10 19 2
1 15 2

15 0 0
17 2 0
7 16 0
1 13 0
16 16 0
7 4 1
9 1 1
9 6 1
5 8 1
8 16 1
13 7 2
15 8 2
0 14 2
11 4 2
