width 20
height 20
@@@.................
@@..................
@@@.@.......@.......
@@@.................
.............@.....@
...................@
@@...@.....@.....@@@
............@..@.@@@
.................@@@
...@.....@..........
....@......@.@......
..@...............@.
.............@....@.
..........@...@.....
..................@.
....@...............
..................@.
.........@..........
.@@..@..............
.@@.................
14
7 14 0
16 6 0
5 14 0
10 14 0
13 6 0
19 3 1
13 1 1
3 14 1
2 1 1
1 9 1
11 8 2
8 1 2
7 15 2
5 1 2

19 2 0
6 5 0
9 8 0
17 2 0
13 11 0
14 2 1
16 7 1
14 4 1
8 2 1
5 15 1
0 19 2
15 19 2
15 11 2
19 12 2
