width 20
height 20
@...................
.......@............
......@.............
....................
..@......@..@@..@...
....................
....................
.@..........@.......
.....@..@...........
.........@..@....@..
.....@..............
..@...@.@....@..@...
....@..@.@..........
....................
@@......@..@........
@@..@..@......@...@.
@@.........@........
..@.................
@...................
...................@
14
16 15 0
9 6 0
7 4 0
10 2 0
5 9 0
9 7 1
19 3 1
3 8 1
0 17 1
19 8 1
3 18 2
16 2 2
12 17 2
8 3 2

6 1 0
8 7 0
16 19 0
1 18 0
17 19 0
4 18 1
3 19 1
3 8 1
9 11 1
18 7 1
18 0 2
6 17 2
13 14 2
3 10 2
