width 20
height 20
....@@..@..@........
@.@...............@.
........@..........@
.........@..........
.....@.......@.@....
........@.......@...
......@..........@..
..........@.@.......
................@...
....................
@...........@.......
...@.@........@...@.
....................
................@...
.........@...@....@.
..........@....@....
........@...........
.........@..........
...........@........
...................@
14
4 12 0
3 12 0
3 10 0
9 4 0
13 6 0
12 13 1
3 4 1
2 0 1
17 2 1
15 12 1
10 5 2
2 17 2
16 12 2
16 10 2

12 19 0
17 12 0
18 12 0
17 19 0
4 15 0
0 8 1
7 1 1
10 0 1
17 3 1
1 4 1
10 2 2
15 5 2
7 12 2
13 9 2
