width 20
height 20
@@....@..@..........
....................
..............@.....
.....@..@.....@.....
..............@...@.
..............@.....
........@..@........
..@.................
.............@.@.@..
....@.........@.....
..........@.........
.........@..@.......
....@........@...@..
.........@..........
..............@.....
...@..@............@
...................@
.........@.@........
.....@......@.......
@@@.................
14
17 1 0
12 12 0
6 2 0
11 3 0
16 15 0
9 9 1
5 0 1
15 18 1
18 18 1
4 15 1
19 5 2
2 8 2
17 18 2
14 11 2

4 2 0
3 19 0
3 16 0
15 11 0
11 16 0
7 8 1
19 19 1
19 10 1
1 1 1
16 10 1
6 14 2
2 2 2
4 0 2
18 10 2
