width 20
height 20
..........@.........
.......@.@........@.
........@...........
.............@.@..@.
.@....@.........@@..
....@......@........
....................
........@.@.........
...............@...@
...@....@....@......
......@.........@...
...............@....
.....@.@............
..................@.
@..........@........
@.@.................
....@......@...@....
.@.......@@@........
.......@@@@@@....@@.
........@@@@@....@@@
14
5 9 0
13 11 0
7 11 0
8 11 0
17 9 0
10 12 1
3 13 1
17 12 1
7 16 1
14 18 1
4 12 2
8 14 2
14 13 2
12 10 2

19 0 0
16 6 0
1 14 0
17 16 0
1 2 0
8 3 1
13 1 1
13 19 1
9 15 1
11 12 1
3 11 2
14 7 2
5 7 2
1 7 2
