width 20
height 20
@@@@@...............
@@@@@..@...@........
@@@@@....@.......@..
@.......@.....@.....
....@.@...@.........
...............@....
..@.....@...........
.@@.................
...............@....
@..@..@.............
............@..@.@..
...........@........
...@...@..@.....@...
...........@.@......
....................
..@...@.....@.......
....@...............
.............@.@....
......@.............
........@...........
14
8 5 0
7 7 0
10 19 0
12 17 0
15 18 0
4 17 1
14 11 1
3 13 1
1 16 1
12 7 1
8 17 2
12 19 2
19 3 2
8 18 2

7 9 0
19 9 0
16 18 0
6 7 0
8 11 0
18 6 1
13 18 1
16 1 1
4 3 1
1 19 1
16 2 2
10 16 2
9 6 2
7 10 2
