width 20
height 20
..........@...@@@@..
..@.................
....................
....................
...@...@.....@......
........@.......@...
..................@.
..@........@...@....
....@...............
.....@..............
..@...............@.
............@..@.@..
@...@....@..........
....................
.......@....@.......
....................
..@@....@...@.......
....................
......@......@......
......@.@.......@...
14
19 18 0
0 18 0
0 16 0
16 4 0
16 15 0
6 10 1
10 5 1
2 2 1
3 5 1
19 11 1
12 6 2
8 8 2
13 7 2
8 14 2

8 10 0
17 8 0
5 14 0
1 18 0
13 3 0
16 2 1
2 19 1
5 7 1
9 16 1
1 4 1
7 17 2
19 19 2
0 19 2
4 14 2
