width 20
height 20
@@@@@........@@@....
@@@@................
@@@........@...@....
@@..................
...................@
......@..@..........
.....@....@......@..
.........@....@.....
........@...........
...@..........@.....
........@.@.....@@..
................@@..
......@@@@.@....@...
....@.......@.......
.............@.@.@..
..............@.....
....................
...@................
.........@..........
....................
14
14 8 0
17 2 0
13 19 0
4 2 0
14 1 0
13 7 1
8 5 1
8 11 1
19 11 1
2 10 1
8 1 2
6 7 2
14 2 2
16 17 2

5 8 0
14 1 0
7 17 0
4 9 0
11 0 0
7 9 1
17 18 1
6 7 1
11 13 1
10 0 1
19 9 2
0 11 2
13 4 2
18 13 2
