width 20
height 20
@@@........@@......@
.............@......
...@................
....@....@.....@....
@....@..............
...............@....
.........@..........
......@....@.@......
....................
...@.....@.......@@@
............@...@@.@
................@@.@
............@.......
.................@..
.....@..............
..........@.........
.........@.....@....
....................
................@...
@.........@..@@.....
14
4 5 0
7 19 0
15 4 0
0 12 0
5 6 0
5 5 1
1 13 1
0 11 1
17 0 1
14 4 1
10 6 2
2 14 2
6 11 2
11 11 2

3 4 0
10 2 0
3 16 0
0 11 0
17 18 0
18 2 1
6 11 1
1 1 1
0 15 1
8 7 1
10 18 2
2 14 2
19 17 2
10 11 2
