width 20
height 20
....................
.........@......@...
...@................
............@...@...
....@...@...........
..........@.........
......@.............
...........@........
...@...............@
.......@..........@@
........@@@....@..@@
........@@....@...@@
....@...............
...........@.....@..
............@.......
..@........@..@.....
.....@..............
@@..........@...@..@
@@@....@...........@
@@@...........@....@
14
0 9 0
8 14 0
10 12 0
16 7 0
10 2 0
14 2 1
0 13 1
4 19 1
10 13 1
13 9 1
9 12 2
3 14 2
4 18 2
19 16 2

6 10 0
3 1 0
8 8 0
0 15 0
5 11 0
1 3 1
4 1 1
8 17 1
10 14 1
13 9 1
18 1 2
5 15 2
13 0 2
0 1 2
