width 20
height 20
@@@.................
@@@.................
.....@..@.@.@.....@.
....................
...@...............@
.....@..@...........
..@.......@...@.....
.......@.........@..
..@.@..............@
......@....@...@....
.........@.........@
.......@.......@....
.........@..@.@..@..
..@........@....@@..
......@.........@@..
.@..................
.............@......
....................
........@...........
..................@.
14
2 7 0
17 3 0
7 5 0
15 6 0
17 11 0
19 9 1
19 18 1
5 19 1
18 13 1
13 12 1
2 10 2
1 3 2
10 5 2
1 9 2

19 11 0
6 4 0
16 15 0
19 6 0
0 3 0
16 12 1
3 1 1
10 1 1
12 0 1
2 3 1
2 10 2
1 3 2
15 18 2
9 16 2
