width 20
height 20
...........@@@......
..@........@@@@@....
....@...............
.......@..@.@.......
.................@..
...@.@..@...@.......
..@............@....
.............@......
..@......@..........
...........@...@.@..
..@.................
....................
..@.@..@.@..@.......
....................
.....@.....@....@...
...@..@.@......@....
....................
.....@....@.........
...@...@.@.@......@.
..............@@....
14
3 3 0
4 3 0
4 0 0
11 5 0
7 4 0
19 16 1
6 11 1
14 17 1
16 7 1
11 17 1
7 14 2
4 13 2
13 12 2
5 4 2

19 19 0
9 2 0
5 1 0
12 13 0
9 10 0
4 19 1
7 0 1
2 14 1
0 18 1
11 11 1
13 10 2
4 8 2
16 17 2
7 19 2
