width 20
height 20
...........@........
....................
..........@.......@.
...@....@..@...@....
@....@..............
....................
@....@.....@..@.....
...@.@..............
...@.....@.......@..
.........@..........
....................
....................
.@.@................
..........@..@....@@
....@.........@...@@
....................
........@......@....
...@@......@..@.....
...@@...............
..@........@........
14
5 9 0
1 5 0
12 5 0
14 11 0
16 12 0
6 12 1
15 13 1
8 12 1
1 9 1
9 3 1
7 9 2
7 3 2
17 19 2
16 6 2

1 5 0
15 5 0
5 17 0
14 9 0
0 0 0
12 3 1
19 0 1
5 12 1
1 9 1
19 19 1
11 10 2
8 9 2
2 13 2
0 16 2
