width 20
height 20
@@.@@...............
@@..................
@......@............
...............@....
.......@............
....@...............
.@.@................
............@.......
........@........@..
...@..@....@........
@....@.......@......
...............@..@.
@......@.@@.......@.
.....@........@.....
....@..@...........@
...................@
.............@.....@
@...@@.....@.@.@...@
@..@.........@...@.@
@........@....@@....
14
2 16 0
14 1 0
8 18 0
14 14 0
3 1 0
5 11 1
18 9 1
5 18 1
14 15 1
12 3 1
8 7 2
10 7 2
7 0 2
14 10 2

1 8 0
3 15 0
7 9 0
16 18 0
18 18 0
12 6 1
16 4 1
8 11 1
16 17 1
7 19 1
9 7 2
1 3 2
17 16 2
7 11 2
