width 20
height 20
............@.......
....................
..@.................
.@....@..........@..
....@.......@@......
.......@....@@......
.................@..
.......@.......@....
....................
..@.@..@....@.....@.
.........@..........
....@.............@.
.....@.....@@.......
.@......@...........
.....@...@.@.@......
....................
...@..........@.....
@......@............
@................@..
....................
14
9 3 0
0 1 0
16 6 0
16 0 0
7 13 0
13 7 1
8 8 1
7 11 1
1 12 1
19 15 1
7 14 2
14 8 2
5 9 2
3 10 2

0 3 0
11 10 0
19 11 0
3 14 0
3 6 0
14 6 1
17 19 1
1 5 1
5 0 1
3 4 1
18 14 2
14 8 2
8 8 2
13 15 2
