width 20
height 20
.......@............
....................
...........@..@.....
.@..............@...
....................
.........@..@@@.....
@...@........@......
................@...
........@......@....
......@......@......
..............@.....
....@...@...........
.@.....@...@........
......@.............
....@...............
............@.......
..........@.........
.@...@..@...........
..........@.@.......
.....@...........@..
14
10 13 0
12 12 0
11 14 0
0 0 0
12 19 0
14 11 1
0 17 1
15 12 1
5 3 1
16 9 1
12 9 2
15 5 2
3 3 2
18 17 2

13 17 0
13 19 0
12 9 0
7 1 0
2 0 0
11 4 1
19 15 1
13 12 1
0 7 1
19 13 1
0 18 2
7 19 2
18 15 2
17 8 2
