width 20
height 20
....@.............@@
....@@.............@
..........@..@......
....................
...@...@@@..........
...........@..@....@
........@@@@........
.....@..@@..........
....................
...@.........@......
.......@....@.@.....
.@....@.........@...
...@.....@...@......
....................
@..@.......@........
....@...@.......@.@.
.................@..
.....@..@...........
......@.............
@............@.@....
14
18 16 0
2 17 0
7 19 0
14 4 0
4 12 0
9 9 1
17 2 1
0 17 1
15 12 1
16 10 1
8 11 2
15 5 2
19 12 2
19 18 2

6 17 0
5 18 0
17 0 0
12 13 0
10 10 0
16 1 1
11 8 1
15 3 1
17 14 1
19 7 1
8 16 2
6 8 2
1 0 2
15 18 2
