width 20
height 20
......@@...@........
.@.......@..........
....................
..................@.
..........@...@...@.
....................
..@.....@.@.........
......@.............
..@......@.@.@..@...
....@.....@.........
....................
......@.............
.@.............@....
...........@........
..............@.....
..@.......@..@......
................@...
.@..................
............@..@.@..
...................@
14
14 3 0
3 14 0
4 19 0
8 1 0
5 15 0
8 17 1
5 13 1
14 18 1
17 16 1
7 9 1
4 10 2
4 16 2
8 18 2
16 14 2

0 14 0
17 4 0
18 14 0
15 17 0
18 16 0
19 5 1
17 11 1
14 17 1
17 13 1
0 11 1
15 4 2
7 7 2
9 17 2
0 3 2
