width 20
height 20
..@.....@@@@..@.....
........@@@@........
....................
@...@..@.....@......
......@.@...........
.....@.....@........
....................
..@....@..........@.
..@............@....
.....@....@.........
.......@............
..................@@
............@.@.@...
.........@..........
.......@...........@
.....@.............@
.@..................
.........@..........
....................
.............@....@.
14
0 11 0
8 8 0
14 19 0
19 7 0
4 2 0
7 13 1
14 5 1
7 17 1
18 12 1
19 0 1
0 17 2
6 10 2
18 0 2
16 2 2

0 10 0
16 0 0
11 2 0
14 14 0
5 7 0
10 5 1
1 19 1
18 5 1
15 1 1
19 3 1
14 4 2
4 9 2
19 0 2
0 8 2
