width 20
height 20
.........@@.........
....................
.......@............
..............@.....
.@.........@.....@..
..........@.........
.......@.......@....
....................
...........@....@...
.............@......
......@............@
...@.@....@.@.......
...........@...@....
@......@....@....@..
....@@@............@
...@....@....@...@.@
..........@........@
....................
....@...........@...
................@@@@
14
6 16 0
10 7 0
5 0 0
11 17 0
18 15 0
6 2 1
19 11 1
0 10 1
6 4 1
8 9 1
18 3 2
0 2 2
14 17 2
12 14 2

6 1 0
14 6 0
10 3 0
18 15 0
19 7 0
4 13 1
0 3 1
10 17 1
8 3 1
8 9 1
5 5 2
3 18 2
17 17 2
0 1 2
