width 20
height 20
....................
...@..@.........@...
.........@....@.....
....@......@.@..@...
......@.............
....@....@..........
............@.......
.@................@@
....@.....@.........
.......@............
...............@....
............@.......
.@@........@........
....@..@............
..............@....@
..........@.........
........@...@.......
.......@.@.@........
..@@................
....................
2
10 10 0
5 18 0

13 12 0
17 3 0
