width 20
height 20
...........@@.......
...@................
.@...@.......@......
...............@....
@@..................
@@...........@......
.@..@......@....@...
.....@.@............
......@.@....@......
.................@..
.....@.......@......
.........@.....@....
.................@..
@.@...............@.
@.....@.....@.......
.....@....@...@.....
....@...........@...
.........@..........
..............@@@@..
.....@@....@@......@
2
19 12 0
9 12 0

1 16 0
18 7 0
