width 20
height 20
..@@........@@......
..@@................
...@.@.@..@.........
..............@.....
.....@..............
....@.@.............
........@..@........
............@.......
......@........@....
.....@..@.....@.....
...........@........
.......@............
....................
....@..@..@..@.@.@..
........@...........
....................
@.........@.........
..................@.
............@.@....@
@.......@..........@
2
5 1 0
6 9 0

16 1 0
0 10 0
