width 20
height 20
....................
....................
....................
....................
@........@..........
@.@.@.....@....@....
...................@
.............@......
@..@.......@..@.@...
........@...........
......@.............
@..@...........@....
.........@..........
...................@
......@.@.@.@..@..@.
....@...............
...@..........@..@@@
..........@.@...@@@@
.......@@........@@@
..@....@@@.......@@@
2
18 11 0
14 5 0

0 1 0
11 14 0
