width 20
height 20
...........@@@......
...........@@@......
.@.............@....
....@.....@.@...@...
.@.....@............
......@........@...@
..@.@.......@.......
................@...
...........@..@.....
....@..@..@.@.@.....
....@...............
@@..@@....@...@.....
@@.................@
@@....@..@........@.
...@.@..@...........
...........@.....@.@
......@.............
...@................
...........@........
.@..................
2
17 2 0
1 15 0

0 7 0
5 1 0
