width 20
height 20
...@................
....@..........@....
....................
.@.......@......@...
.......@......@.....
............@...@...
.....@.......@......
....................
....@..@............
...@..@...@...@.....
............@.......
..@................@
.............@......
....@..@.@..........
......@.........@...
..@.....@...........
.....@.............@
...........@...@..@@
......@.............
.@@@.........@.....@
2
12 8 0
12 3 0

0 18 0
1 18 0
