width 20
height 20
....................
....................
...........@........
....................
.....@......@.......
....@.............@.
....................
.@........@...@..@..
..@...@..........@..
...@........@.......
.......@..@.....@.@.
............@.......
.....@..@.........@.
.@............@..@..
@@...@..............
@@@@...@....@.......
@@@@....@.......@...
@@@@@@..............
@@@@@@..............
@@@@@@.....@@.......
2
9 4 0
2 4 0

19 12 0
5 3 0
