width 20
height 20
.............@@....@
.......@............
......@...@.@....@..
..............@.....
@.......@.........@.
..@.........@......@
....@.@.....@..@..@@
.........@..@....@@@
@@..................
@...@.@......@......
...@........@.......
.......@............
.@..........@..@....
..........@.........
....................
..@.........@.......
@.....@......@......
.....@....@......@..
....................
....................
2
5 1 0
10 3 0

11 19 0
19 17 0
