width 20
height 20
@@@@......@.........
@@..................
@@......@.......@...
......@.......@.....
.....@.......@......
..........@.........
@..@.........@.@....
...........@.....@..
....@...@...........
@......@.@..........
@.................@.
....@...............
......@..@.......@..
...........@.@....@.
....................
.....@.....@........
................@.@.
.........@..........
.@.......@..........
.....@....@........@
2
10 12 0
5 11 0

3 1 0
19 11 0
