width 20
height 20
@................@@@
@.@............@..@@
@.....@.@...@.@...@@
@..................@
..........@.........
.@.@................
........@.......@...
.............@......
..@..@..@...........
............@...@...
....................
...@..@......@......
...............@....
.......@............
....................
.@.......@.@.......@
....................
................@...
....@............@..
....@@@.............
2
11 4 0
1 4 0

9 5 0
17 2 0
