width 20
height 20
............@....@..
...........@........
....@.@.@.....@.@...
........@...........
..@..........@.@@...
........@...........
..............@.....
...@................
...............@.@.@
....@.@.@...@...@..@
.......@..@........@
.@...............@..
...@.....@....@@....
...........@.@......
....@..@.......@....
....................
..@.@....@..@.......
.................@..
.................@.@
.......@@........@..
2
19 13 0
7 1 0

7 12 0
12 19 0
