width 20
height 20
.................@@.
..@............@....
@................@..
@........@..@.......
@...................
....................
...........@........
....................
...........@..@.....
......@..@...@....@.
..................@@
....@..........@..@@
.........@..@.@.....
..@.@.....@.@.......
.............@.@....
.....@...........@..
...............@.@..
.@...........@......
..........@...@.....
....................
2
16 12 0
15 5 0

15 3 0
7 3 0
