width 20
height 20
....................
....................
...@...........@@@..
...........@..@.....
....@.@....@@.......
........@....@..@...
....................
..@.@...@....@......
..................@.
................@...
.@..................
...........@...@....
...@..@..@@.........
....................
...............@....
.......@............
............@...@...
.....@..@......@....
....................
.............@@....@
2
8 18 0
8 9 0

17 15 0
1 9 0
