width 20
height 20
@@.........@........
@..@................
@........@@.........
@......@........@...
....................
........@...........
....@.....@....@....
...@@.......@.@..@..
.@........@.........
......@.............
....................
.@..@...............
.......@......@.....
.....@.........@.@..
..........@.........
@.....@.@....@...@..
.@...........@......
.@..................
....................
@...................
2
16 6 0
2 17 0

14 18 0
11 7 0
