width 20
height 20
....................
....................
.......@...@.@......
....................
......@.........@...
.........@.....@.@..
...@..@.@...........
.....@.@............
...........@..@.....
......@..........@..
..@......@..........
....................
.......@............
....................
@...@..........@...@
@........@......@...
@...........@.......
@...................
......@...@.........
..............@@...@
2
3 14 0
9 18 0

10 1 0
6 1 0
