width 20
height 20
@........@..........
@...................
....@.@....@....@...
........@........@..
@...@.....@.........
@..........@...@@...
@......@............
@...@........@.@....
@@........@.........
.........@........@.
.....@.@....@.@.....
........@...........
.....@....@.........
.....@...@...@......
@@.................@
@..@.....@.....@....
..................@.
...@........@.......
....................
.....@@....@..@.....
12
12 15 0
13 12 0
18 4 0
18 10 0
19 11 1
7 7 1
7 4 1
14 8 1
5 17 2
6 15 2
1 9 2
8 2 2

12 15 0
14 4 0
0 18 0
13 18 0
17 10 1
6 9 1
9 11 1
4 18 1
4 9 2
1 2 2
15 17 2
6 0 2
