width 20
height 20
@@@@@...............
@...@.....@.........
...................@
........@......@.@..
.............@......
....@...............
@.@......@....@...@.
....................
....@............@..
.....@...@.....@....
....@.......@.......
.......@............
...............@....
...........@.@......
.@..................
.@..................
....@...@.@..@..@...
..............@..@..
....................
....................
12
13 15 0
1 16 0
4 3 0
1 7 0
0 4 1
18 9 1
16 19 1
2 17 1
17 16 2
16 4 2
10 4 2
16 11 2

0 18 0
16 11 0
11 18 0
16 18 0
1 1 1
2 14 1
16 19 1
18 7 1
9 1 2
16 4 2
12 3 2
11 6 2
