width 20
height 20
@@@@................
@@@@............@...
..@.................
..@...@........@....
.........@.@........
....................
...........@........
..........@.@......@
....@...............
.........@.....@....
......@.......@.....
..@.................
@....@.............@
........@...........
....@...............
.............@.@....
..@..@..............
....................
..@@................
..@@.....@..........
12
3 15 0
17 17 0
6 15 0
15 18 0
11 5 1
18 2 1
3 3 1
2 12 1
13 19 2
12 11 2
4 10 2
2 15 2

19 3 0
12 15 0
18 0 0
0 5 0
19 19 1
3 15 1
15 10 1
2 12 1
15 17 2
11 9 2
5 10 2
8 16 2
