width 20
height 20
@@@.................
@...................
...........@........
....................
...@......@.........
....................
............@.....@.
......@.@...........
.@..@....@..........
...........@........
...............@....
...@..........@.....
..@.@...............
.............@......
.........@..........
.....@.......@.@....
............@.......
.........@..........
...................@
.@.....@@..........@
12
0 11 0
6 16 0
5 13 0
7 8 0
1 15 1
18 8 1
14 12 1
17 3 1
19 14 2
7 1 2
17 13 2
4 0 2

18 0 0
7 13 0
10 17 0
15 2 0
8 14 1
0 18 1
18 2 1
17 8 1
10 8 2
19 8 2
16 6 2
2 5 2
