width 20
height 20
@.......@.....@@....
....................
.........@.@...@....
....@.@..........@..
....................
..................@.
..@...@.............
....................
....@...@...@.......
................@.@.
....................
......@......@......
.@..........@...@...
........@....@......
....................
..@@......@.........
............@.......
....................
........@...........
................@...
12
9 7 0
4 15 0
18 13 0
8 17 0
11 0 1
10 19 1
6 14 1
17 12 1
13 6 2
16 17 2
13 1 2
10 2 2

5 14 0
16 5 0
19 6 0
3 6 0
19 7 1
3 10 1
17 2 1
7 8 1
3 14 2
14 12 2
1 14 2
5 11 2
