width 20
height 20
...................@
...@.@.............@
@@..................
@@..........@.@.....
....@.@..........@..
@@..................
.................@..
.....@..@....@......
.......@...@........
.................@.@
....................
@@..@....@.@........
............@.@@@.@.
.......@@.....@@....
@..@....@.....@...@.
.....@@@@.....@.....
.....@@@@...@@@.....
.....@@@.........@..
.....@@.............
......@............@
12
19 16 0
11 18 0
15 19 0
16 19 0
12 5 1
7 5 1
13 13 1
19 6 1
6 6 2
6 5 2
9 6 2
13 14 2

6 8 0
4 14 0
1 0 0
12 7 0
15 17 1
18 19 1
0 13 1
1 13 1
12 18 2
19 12 2
14 8 2
3 3 2
