width 20
height 20
....@@.......@......
.....@..............
....................
..@.....@...@....@..
....@.........@...@.
......@...@.........
.............@......
...................@
.@...@..@..........@
...........@..@..@..
.....@..............
....@.....@.......@.
......@.............
........@......@....
....@...............
..@.................
........@....@@.....
..@......@..........
.................@..
.@..................
12
17 0 0
7 11 0
12 0 0
17 11 0
16 12 1
3 6 1
2 10 1
1 14 1
1 4 2
9 16 2
15 10 2
7 0 2

16 4 0
2 13 0
12 1 0
13 5 0
0 9 1
4 18 1
10 10 1
13 15 1
2 6 2
13 17 2
15 6 2
0 5 2
