width 20
height 20
@@....@@.........@@@
@@................@@
...@..............@.
.......@...@........
..........@@........
..........@@........
.....@..............
.@........@.........
.......@.@.......@..
...@....@.......@.@.
.............@.@....
.........@..........
..@...@.............
.....@.........@.@@@
......@.............
..........@...@.....
..@...@.............
....................
....@...............
..........@@@.@@@@..
12
19 17 0
14 17 0
11 10 0
18 4 0
4 0 1
16 6 1
5 16 1
1 10 1
3 6 2
2 15 2
8 10 2
12 5 2

5 12 0
3 12 0
4 6 0
3 5 0
18 19 1
15 15 1
7 10 1
19 15 1
14 13 2
13 8 2
7 11 2
19 19 2
