width 20
height 20
@..............@@...
...............@@@..
............@..@@...
...@..@.............
....................
...@..@....@........
..@.................
......@....@.@.@....
........@...@.@.....
...@..@.............
..........@.........
..............@..@..
..@....@@...@.......
......@.............
......@.......@.....
..........@.........
........@...@.......
.................@..
...........@........
....@...............
12
18 17 0
10 9 0
6 15 0
7 11 0
9 9 1
2 7 1
9 18 1
12 11 1
3 10 2
18 18 2
10 6 2
10 8 2

18 12 0
1 2 0
6 15 0
18 18 0
18 7 1
12 17 1
19 10 1
1 0 1
9 19 2
4 0 2
1 18 2
0 15 2
