width 20
height 20
....................
....@..@@..@.....@..
.............@......
.......@............
..@........@........
....................
..............@..@.@
...@.@....@......@@@
......@....@.....@@@
.........@.......@@@
.................@@@
.................@..
....@...@.@.........
............@.......
....................
....@.............@@
@....@............@@
@@......@.@.......@@
...........@..@@..@@
.............@@@..@@
12
10 18 0
9 1 0
16 19 0
19 0 0
4 9 1
2 18 1
1 7 1
3 6 1
11 13 2
17 16 2
12 8 2
11 14 2

18 3 0
8 4 0
10 14 0
11 9 0
18 4 1
13 4 1
4 17 1
7 4 1
8 2 2
3 18 2
1 18 2
6 11 2
