width 20
height 20
@.................@@
@.................@@
.................@@.
.....@............@.
....................
..@........@..@.....
............@..@...@
...@................
....................
....@..@.@..........
....................
.........@..@.......
.....@..............
..............@.....
..@.@...............
........@...........
....@..............@
........@.....@.....
....@...@...........
........@@@.........
12
17 10 0
7 8 0
0 9 0
11 19 0
19 4 1
9 2 1
5 10 1
5 4 1
2 11 2
0 3 2
12 3 2
13 11 2

18 10 0
19 18 0
12 13 0
9 8 0
15 9 1
11 17 1
6 10 1
7 5 1
1 13 2
0 5 2
11 3 2
17 11 2
