width 20
height 20
@...................
....................
....@.......@..@.@..
....................
...............@....
@.......@..@........
...@.....@..........
..@.................
.@....@........@....
.......@....@.......
...................@
............@...@...
....................
@..@.@...@..........
..@...........@.....
........@...........
.........@..........
....................
..@............@....
....................
12
5 11 0
9 4 0
15 15 0
7 2 0
16 16 1
16 5 1
12 19 1
1 10 1
11 17 2
19 14 2
14 5 2
8 1 2

6 11 0
6 4 0
12 13 0
13 9 0
17 1 1
1 17 1
4 6 1
4 14 1
10 17 2
1 0 2
11 3 2
6 0 2
