width 20
height 20
..................@@
....................
.....@......@..@....
....................
............@.......
.@........@.........
....................
......@....@........
@.........@.........
.....@...@.....@....
...@........@...@...
.......@.@.@.@......
.....@....@....@....
.......@............
..@.....@.@..@......
....................
.....@..@...........
.......@.@.....@....
..................@@
................@@@@
12
10 2 0
11 14 0
2 12 0
14 3 0
17 15 1
6 13 1
18 2 1
1 8 1
9 1 2
6 17 2
8 2 2
13 1 2

6 0 0
4 16 0
16 2 0
11 16 0
16 11 1
19 3 1
18 3 1
4 6 1
9 1 2
18 4 2
3 15 2
1 1 2
