width 20
height 20
@@.@@@@@@@.@@@@@@@@@
@..@@@@@@...@@@@@@@@
@.@@@@@@.@.@.@@@@@@@
@..@@@.....@..@.@@@.
@.@.@..@@.@..@...@..
.....@.@.@.@.@@@...@
@.@@..........@.@@..
..@..@.@.@@.@....@.@
.@.@.@@..@.@..@@....
@....@.@@...@@@@.@.@
@.@.@..@.@.@.@@.@@..
@@@@.@.............@
@@@@...@.@@.@.@@.@.@
@@@.@.@..@@@.@..@.@.
@@@.@@@@..@@..@.@...
@@.......@@.@.....@@
@@@.@@.@.@....@.@@@@
@@@@@.@....@.@..@@@@
@@@....@.@@@@@@@@@@@
@@@@@@....@@@@@@@@@@
4
4 11 0
13 16 0
8 3 0
12 6 0

13 8 0
10 0 0
5 6 0
7 8 0
