width 20
height 20
.........@.@...@.@.@
.@.@@.@.@...@@......
@...@.@.@.@@.@.@.@@.
@.@@.@.@..@.....@@@.
.........@.@.@.@....
.@.@.@.@......@@.@@.
.@@@..@.@.@@.@@@@.@@
@.@..@@....@@.@@....
...@.@..@.@...@.@.@.
.@@@@..@@.@.@......@
.@.@@.@.@@.@.@@.@.@@
.................@@@
.@.@.@@.@@@@.@.@.@@@
@.@..@....@.@..@.@@@
...@@@.@@@....@@@@@@
@.@..@..@.@.@..@@@@@
...@...@.....@.@@@@@
@.@@.@@@@@.@.@..@@@@
.......@@@@...@.@@@@
@.@.@@@@@@@@.@..@@@@
4
6 3 0
3 7 0
1 16 0
13 13 0

6 5 0
7 13 0
3 0 0
8 11 0
