width 20
height 20
@.@@.@.@.@@@@..@..@.
.......@..@...@.@...
.@.@.@.@.@.@@.@...@.
..@@@...........@.@@
.@.@.@@@.@.@.@.@..@.
.@........@@@@@@@...
@@.@.@.@.@.@.@.@..@.
@.@.@.@.@@.@...@@..@
.............@.@..@.
.@.@.@.@.@.@.@.@@...
..@@..@..@@@@..@@@@.
.@.@@@..@..@.@.@@@..
....@@@@@.@........@
@.@..@.@...@.@.@.@@@
@@.@....@.@@@...@..@
.....@.@..@@..@@..@.
@.@.@@@@.@...@@@.@..
...@.......@.@@@..@.
@.@..@.@.@..@.@.@...
@@@@..@...@.......@@
4
10 13 0
15 18 0
2 17 0
19 0 0

17 12 0
12 1 0
2 17 0
4 9 0
