width 20
height 20
@.@..@@@@@@@@@.@...@
....@..@@@@@@...@.@.
@.@...@@@@@.@.@.....
@@.@@..@@@...@..@.@.
......@@@@@.@.@..@..
@.@@.@@.@@@.@...@.@.
..@...........@@@...
.@@@@@.@@@.@.@@@@@@.
@...@@@....@@@@@@@@.
@@.@.@..@@.@..@@@@@@
@......@.@@@@...@@@@
.@.@.@.......@.@@@@@
....@@.@@.@@.@..@@@@
.@.@@@@..@@....@@@@@
.@...@.@.@.@.@.@@@@@
@@.@@........@..@@@@
@@@..@.@.@.@.@.@@@@@
@@.@.@.@@...@...@@@@
.........@.@@@.@@@@@
.@.@.@@.@@@@@@@@@@@@
4
0 12 0
5 2 0
7 5 0
11 3 0

3 10 0
2 10 0
7 18 0
11 17 0
