width 20
height 20
..@....@@@@@@.@@....
@..@@.@.@@@@...@@.@.
.@........@.@.@...@.
...@.@@.@.@.....@@..
.@..@@@..@@@.@.@..@.
.@.@.@.@@.@.@.@.@...
@@................@.
@.@.@@@.@.@.@.@.@.@.
......@@@@@@.@...@.@
@.@.@.@.@@@@..@.@..@
@..@.....@@@@.....@@
..@@@.@@@@@@@@.@.@@@
@..@@..@.@@@@@@@@@@@
@@...@....@@@@@@@@@@
@..@@@@.@@@@@@@@@@@@
..@@@@@@@@@@@@@@@@@@
@.@@@@@@@@@@@@@@@@@@
...@@@@@@@@@@@@@@@@@
@.@@@@@@@@@@@@@@@@@@
..@@@@@@@@@@@@@@@@@@
4
3 4 0
2 10 0
18 5 0
19 0 0

17 0 0
7 4 0
2 13 0
3 7 0
