width 20
height 20
@@@@@@.@.@..@@...@@.
@@@@@@....@....@@.@.
@@@@@..@@.@.@@......
@.@@.@...@..@@@.@.@.
.......@.@@.@@..@@..
@.@@.@..@@...@.@..@.
@...@@@...@.@..@@...
..@@@@@@.@...@..@.@@
@.@.@.@.@.@@.@.@...@
....@.@.......@.@.@.
@.@.....@@.@.@......
...@.@.@@@@@@.@.@@.@
@.@.@@@@@..@......@@
@.@.@@@@.@.@@.@@@.@@
...........@..@.@.@@
@.@.@@.@.@@@@....@.@
@@@...@@@@@@@@.@...@
@..@.@@@.@@.@.@.@@..
@@....@@...........@
@@@@.@...@.@.@.@.@..
4
7 10 0
18 16 0
5 16 0
12 7 0

1 14 0
1 4 0
11 5 0
5 14 0
