width 20
height 20
@..@@@@@@@...@.@@.@.
.@..@@@@...@........
...@.@@.@@..@.@.@.@@
.@...@...@@@@@..@@@.
.@@@..@.@@@@@.@.....
@.@.@.@.@@@@....@.@.
.........@@..@.@.@..
@.@.@@.@.@.@.@@....@
...@@@@@.@.@.@.@.@@.
@.@.@@......@.......
.....@.@.@.@.@.@@.@.
@@.@..@@@.....@...@.
.@@..@@@@@.@.@@@.@..
.@@@.@@@@@@@@.@.@.@.
..@...@@@@.@......@.
.@.@.@.@@....@.@@...
..........@.@..@@@.@
@.@.@.@.@.@@@@..@@@@
@..@...@@@@@@..@@@@@
@.@@@.@@@@@@@@..@@@@
4
4 4 0
5 17 0
4 18 0
15 5 0

4 11 0
14 15 0
4 4 0
7 2 0
