width 20
height 20
...@@.@@@@@@.@@@@@@@
@.@.@..@@@@@...@@@@@
......@@@@.@.@@@.@.@
@@.@@.@....@.@@.....
.@@.@.@@.@.....@.@.@
.......@@@@@.@.@@@.@
.@@.@.@..@..@....@..
@....@.@.@@..@.@.@.@
@@.@@@...@.@.@..@...
@..@@@@@.......@.@.@
@@.@@@...@.@.@......
@....@.@.@@@@.@.@@.@
.@.@@...@@@.....@...
......@@@@@@@.@.@@.@
@.@.@....@@.@.@@@...
@@...@.@.....@....@@
@@@.@@@@.@@.@@@.@.@.
@@@.@@..@...@@...@..
@@@@...@..@.@@@.@.@.
@@@@@@...@...@......
4
15 15 0
2 8 0
2 11 0
5 13 0

19 6 0
12 8 0
5 4 0
2 9 0
