width 20
height 20
@@@.....@.@@.@.@....
@@..@.@..........@@@
@@@@@@@.@.@.@.@.@.@.
@@@.@...@..@..@.....
@.....@.@.@.@@@@.@.@
..@.@..@......@.@..@
@..@.@@@@@.@.@@.@@..
..@..@@@@@@@......@.
@..@..@@@@@@@.@.@..@
@@...@@@@@@@@@@@..@@
@@@@.@@@@@@@@@@@@.@.
@@@@@@@@@@@@@@@@....
@@@@@@@@@@@@@@@@@.@@
@@@@@@@@@@@@@@@@@@@@
@@@@@@@@@@@@@@@@@@@@
@@@@@@@@@@@@@@@@@@@@
@@@@@@@@@@@@@@@@@@@@
@@@@@@@@@@@@@@@@@@@@
@@@@@@@@@@@@@@@@@@@@
@@@@@@@@@@@@@@@@@@@@
4
7 1 0
12 7 0
15 2 0
4 0 0

18 11 0
7 3 0
17 10 0
2 8 0
