width 20
height 20
....@..@.@....@...@@
@.@.@.@..@@.@...@@.@
..@.....@.@@..@@...@
@..@@.@...@..@.@@@..
@@@...@@@@.@...@...@
@..@.@@..@...@..@@..
.@...@..@@.@@..@..@.
...@.@@....@@@...@..
.@@.@...@@.@@@@@.@@.
......@.@@@.@@@.@...
@.@@.@............@.
....@@@.@@.@@@@.@@..
@.@.@@.@@......@@@@.
@@...@...@.@.@..@@@.
@@@.@@@@..@@@..@@@@@
@@@@.@..@...@@.@@@@@
@@.....@.@@.@@.@@@@@
@..@.@@@........@@@@
@@..@.@@.@@.@@.@@@@@
@@@......@..@..@@@@@
4
10 10 0
1 10 0
10 7 0
3 12 0

1 2 0
3 16 0
4 6 0
2 5 0
