width 20
height 20
.@...@@.........@..@
...@...@@.@@@@.@.@..
.@..@.@..@.........@
..@.@..@.@@@@.@.@@@@
.@.@.@.....@...@@@@@
.....@@.@.@@@.@.@.@@
@.@@.@@@@@@.....@.@@
@@....@.@..@@.@....@
@@@.@.....@.@@.@@.@.
@@.@@@.@@....@......
......@...@@.@.@@@.@
@@.@@...@.@@@.....@@
...@.@.@...@.@.@.@@@
.@.@...@.@......@@@@
.@@.@@@.@.@@.@.@@@@@
......@.......@@@@@@
.@.@.@@@@.@.@@.@@@@@
..@...@...@....@@@@@
@..@.@.@@..@.@@@@@@@
..@@@.....@@.@@@@@@@
4
11 6 0
2 12 0
6 13 0
13 5 0

7 4 0
2 10 0
2 1 0
12 15 0
