width 20
height 20
@@@@@@@@@.@..@@....@
@@@@@.@....@.@.@.@@.
@@@@..@.@@..........
@.@.@.@..@.@@@.@@.@.
......@.@..@@@@..@..
@.@.@....@.@@@..@@@.
@..@..@.@..@@.@..@..
..@.@..@@@.@....@.@@
@...@.@.@.@.@.@@..@.
..@..@........@.@.@.
.@@.@.@.@.@.@.......
.@.......@@@@.@.@@@@
..@.@.@.@@@...@....@
@@@@@@..@@.@.@.@@.@@
@.@.@@@.@......@...@
@....@@.@@.@@.@@@.@@
..@@@@.@.@..@@@@@@@@
@..........@@@@@@@@@
@.@.@.@.@@....@@@@@@
@@..@.@@...@@@@@@@@@
4
5 12 0
9 14 0
13 9 0
11 16 0

5 11 0
13 8 0
10 1 0
15 4 0
