width 20
height 20
.@@@@....@.@.@.@@@..
...@..@@.......@@.@.
@.@@.@@@@@.@.@....@.
......@@@..@.@.@@...
.@.@.@@.@@..@...@@@.
..@@@@.....@@@.@....
.@.@.@@@.@..@..@@.@.
.......@@@@@@@.@@.@.
.@.@.@...@..@..@@@@@
.@.@@..@@..@.@..@@@.
@.@.@@..@@....@..@..
.......@@.@@.@@.@.@.
.@.@.@@.............
..@@@@.@@.@.@.@.@.@.
@@@@@@..@.@.@..@@..@
...@@.@..@@@@@.@..@@
@.@.@.@.@.@.@.@.@..@
................@.@.
@.@.@.@.@.@.@.@.....
..@..@...@...@..@.@.
4
7 18 0
7 4 0
11 4 0
1 13 0

18 12 0
6 14 0
3 17 0
6 0 0
