width 20
height 20
@@@..@@.@@.@@..@@.@.
@@..@....@.@.@..@...
@.@...@.@..@...@..@.
..@.@@.@.@.@.@@.@..@
@.................@.
..@.@.@@@.@.@.@.@.@.
@..@@....@@@@@@@@@..
..@@@@@@@.@.@.@.@.@.
@..@.@.@............
..@.....@.@.@@@.@@.@
.@.@@.@..@@@.@@.@@..
......@@..@..@.@.@.@
@.@@.@.@.@.@.@.@.@..
@@..@..............@
.@.@..@.@@.@.@.@@.@@
....@@...@.@@.@.@@..
@.@.@.@.@.@........@
@.@.........@.@.@.@@
...@.@@.@.@..@@@...@
@.@....@@@@@@@@@@.@@
4
5 5 0
11 11 0
14 13 0
10 2 0

3 2 0
12 12 0
12 13 0
2 10 0
